省份,年份,文理综合,当前分数人数,分数,总人数
吉林,2021,理科,101,669,101
吉林,2021,理科,9,668,110
吉林,2021,理科,7,667,117
吉林,2021,理科,7,666,124
吉林,2021,理科,10,665,134
吉林,2021,理科,9,664,143
吉林,2021,理科,16,663,159
吉林,2021,理科,7,662,166
吉林,2021,理科,5,661,171
吉林,2021,理科,12,660,183
吉林,2021,理科,7,659,190
吉林,2021,理科,9,658,199
吉林,2021,理科,13,657,212
吉林,2021,理科,9,656,221
吉林,2021,理科,20,655,241
吉林,2021,理科,15,654,256
吉林,2021,理科,19,653,275
吉林,2021,理科,20,652,295
吉林,2021,理科,17,651,312
吉林,2021,理科,15,650,327
吉林,2021,理科,10,649,337
吉林,2021,理科,18,648,355
吉林,2021,理科,23,647,378
吉林,2021,理科,32,646,410
吉林,2021,理科,20,645,430
吉林,2021,理科,21,644,451
吉林,2021,理科,25,643,476
吉林,2021,理科,21,642,497
吉林,2021,理科,26,641,523
吉林,2021,理科,24,640,547
吉林,2021,理科,34,639,581
吉林,2021,理科,27,638,608
吉林,2021,理科,33,637,641
吉林,2021,理科,31,636,672
吉林,2021,理科,31,635,703
吉林,2021,理科,29,634,732
吉林,2021,理科,30,633,762
吉林,2021,理科,33,632,795
吉林,2021,理科,36,631,831
吉林,2021,理科,33,630,864
吉林,2021,理科,32,629,896
吉林,2021,理科,31,628,927
吉林,2021,理科,40,627,967
吉林,2021,理科,46,626,1013
吉林,2021,理科,39,625,1052
吉林,2021,理科,35,624,1087
吉林,2021,理科,42,623,1129
吉林,2021,理科,39,622,1168
吉林,2021,理科,42,621,1210
吉林,2021,理科,36,620,1246
吉林,2021,理科,33,619,1279
吉林,2021,理科,40,618,1319
吉林,2021,理科,52,617,1371
吉林,2021,理科,42,616,1413
吉林,2021,理科,32,615,1445
吉林,2021,理科,56,614,1501
吉林,2021,理科,40,613,1541
吉林,2021,理科,56,612,1597
吉林,2021,理科,58,611,1655
吉林,2021,理科,48,610,1703
吉林,2021,理科,62,609,1765
吉林,2021,理科,58,608,1823
吉林,2021,理科,39,607,1862
吉林,2021,理科,50,606,1912
吉林,2021,理科,51,605,1963
吉林,2021,理科,65,604,2028
吉林,2021,理科,49,603,2077
吉林,2021,理科,54,602,2131
吉林,2021,理科,59,601,2190
吉林,2021,理科,75,600,2265
吉林,2021,理科,60,599,2325
吉林,2021,理科,44,598,2369
吉林,2021,理科,69,597,2438
吉林,2021,理科,67,596,2505
吉林,2021,理科,75,595,2580
吉林,2021,理科,55,594,2635
吉林,2021,理科,62,593,2697
吉林,2021,理科,62,592,2759
吉林,2021,理科,64,591,2823
吉林,2021,理科,87,590,2910
吉林,2021,理科,93,589,3003
吉林,2021,理科,70,588,3073
吉林,2021,理科,80,587,3153
吉林,2021,理科,83,586,3236
吉林,2021,理科,83,585,3319
吉林,2021,理科,94,584,3413
吉林,2021,理科,83,583,3496
吉林,2021,理科,85,582,3581
吉林,2021,理科,76,581,3657
吉林,2021,理科,107,580,3764
吉林,2021,理科,79,579,3843
吉林,2021,理科,97,578,3940
吉林,2021,理科,86,577,4026
吉林,2021,理科,83,576,4109
吉林,2021,理科,100,575,4209
吉林,2021,理科,90,574,4299
吉林,2021,理科,103,573,4402
吉林,2021,理科,86,572,4488
吉林,2021,理科,108,571,4596
吉林,2021,理科,123,570,4719
吉林,2021,理科,89,569,4808
吉林,2021,理科,117,568,4925
吉林,2021,理科,95,567,5020
吉林,2021,理科,98,566,5118
吉林,2021,理科,108,565,5226
吉林,2021,理科,132,564,5358
吉林,2021,理科,99,563,5457
吉林,2021,理科,123,562,5580
吉林,2021,理科,117,561,5697
吉林,2021,理科,103,560,5800
吉林,2021,理科,108,559,5908
吉林,2021,理科,115,558,6023
吉林,2021,理科,121,557,6144
吉林,2021,理科,119,556,6263
吉林,2021,理科,110,555,6373
吉林,2021,理科,109,554,6482
吉林,2021,理科,119,553,6601
吉林,2021,理科,143,552,6744
吉林,2021,理科,104,551,6848
吉林,2021,理科,136,550,6984
吉林,2021,理科,137,549,7121
吉林,2021,理科,97,548,7218
吉林,2021,理科,118,547,7336
吉林,2021,理科,149,546,7485
吉林,2021,理科,153,545,7638
吉林,2021,理科,126,544,7764
吉林,2021,理科,112,543,7876
吉林,2021,理科,109,542,7985
吉林,2021,理科,134,541,8119
吉林,2021,理科,158,540,8277
吉林,2021,理科,153,539,8430
吉林,2021,理科,114,538,8544
吉林,2021,理科,142,537,8686
吉林,2021,理科,123,536,8809
吉林,2021,理科,176,535,8985
吉林,2021,理科,144,534,9129
吉林,2021,理科,132,533,9261
吉林,2021,理科,137,532,9398
吉林,2021,理科,132,531,9530
吉林,2021,理科,142,530,9672
吉林,2021,理科,149,529,9821
吉林,2021,理科,158,528,9979
吉林,2021,理科,166,527,10145
吉林,2021,理科,129,526,10274
吉林,2021,理科,144,525,10418
吉林,2021,理科,170,524,10588
吉林,2021,理科,135,523,10723
吉林,2021,理科,134,522,10857
吉林,2021,理科,143,521,11000
吉林,2021,理科,163,520,11163
吉林,2021,理科,159,519,11322
吉林,2021,理科,179,518,11501
吉林,2021,理科,160,517,11661
吉林,2021,理科,168,516,11829
吉林,2021,理科,176,515,12005
吉林,2021,理科,152,514,12157
吉林,2021,理科,144,513,12301
吉林,2021,理科,166,512,12467
吉林,2021,理科,185,511,12652
吉林,2021,理科,182,510,12834
吉林,2021,理科,175,509,13009
吉林,2021,理科,202,508,13211
吉林,2021,理科,175,507,13386
吉林,2021,理科,194,506,13580
吉林,2021,理科,188,505,13768
吉林,2021,理科,194,504,13962
吉林,2021,理科,184,503,14146
吉林,2021,理科,178,502,14324
吉林,2021,理科,190,501,14514
吉林,2021,理科,184,500,14698
吉林,2021,理科,188,499,14886
吉林,2021,理科,161,498,15047
吉林,2021,理科,204,497,15251
吉林,2021,理科,186,496,15437
吉林,2021,理科,209,495,15646
吉林,2021,理科,208,494,15854
吉林,2021,理科,204,493,16058
吉林,2021,理科,187,492,16245
吉林,2021,理科,204,491,16449
吉林,2021,理科,192,490,16641
吉林,2021,理科,196,489,16837
吉林,2021,理科,182,488,17019
吉林,2021,理科,180,487,17199
吉林,2021,理科,177,486,17376
吉林,2021,理科,190,485,17566
吉林,2021,理科,204,484,17770
吉林,2021,理科,191,483,17961
吉林,2021,理科,211,482,18172
吉林,2021,理科,198,481,18370
吉林,2021,理科,197,480,18567
吉林,2021,理科,192,479,18759
吉林,2021,理科,234,478,18993
吉林,2021,理科,204,477,19197
吉林,2021,理科,215,476,19412
吉林,2021,理科,208,475,19620
吉林,2021,理科,188,474,19808
吉林,2021,理科,231,473,20039
吉林,2021,理科,207,472,20246
吉林,2021,理科,203,471,20449
吉林,2021,理科,208,470,20657
吉林,2021,理科,241,469,20898
吉林,2021,理科,209,468,21107
吉林,2021,理科,197,467,21304
吉林,2021,理科,227,466,21531
吉林,2021,理科,199,465,21730
吉林,2021,理科,200,464,21930
吉林,2021,理科,210,463,22140
吉林,2021,理科,219,462,22359
吉林,2021,理科,220,461,22579
吉林,2021,理科,255,460,22834
吉林,2021,理科,217,459,23051
吉林,2021,理科,238,458,23289
吉林,2021,理科,250,457,23539
吉林,2021,理科,194,456,23733
吉林,2021,理科,240,455,23973
吉林,2021,理科,243,454,24216
吉林,2021,理科,219,453,24435
吉林,2021,理科,231,452,24666
吉林,2021,理科,244,451,24910
吉林,2021,理科,229,450,25139
吉林,2021,理科,222,449,25361
吉林,2021,理科,212,448,25573
吉林,2021,理科,227,447,25800
吉林,2021,理科,243,446,26043
吉林,2021,理科,260,445,26303
吉林,2021,理科,230,444,26533
吉林,2021,理科,229,443,26762
吉林,2021,理科,221,442,26983
吉林,2021,理科,229,441,27212
吉林,2021,理科,252,440,27464
吉林,2021,理科,237,439,27701
吉林,2021,理科,241,438,27942
吉林,2021,理科,254,437,28196
吉林,2021,理科,253,436,28449
吉林,2021,理科,244,435,28693
吉林,2021,理科,247,434,28940
吉林,2021,理科,238,433,29178
吉林,2021,理科,231,432,29409
吉林,2021,理科,250,431,29659
吉林,2021,理科,239,430,29898
吉林,2021,理科,230,429,30128
吉林,2021,理科,249,428,30377
吉林,2021,理科,251,427,30628
吉林,2021,理科,252,426,30880
吉林,2021,理科,242,425,31122
吉林,2021,理科,227,424,31349
吉林,2021,理科,254,423,31603
吉林,2021,理科,253,422,31856
吉林,2021,理科,247,421,32103
吉林,2021,理科,233,420,32336
吉林,2021,理科,267,419,32603
吉林,2021,理科,257,418,32860
吉林,2021,理科,244,417,33104
吉林,2021,理科,262,416,33366
吉林,2021,理科,255,415,33621
吉林,2021,理科,221,414,33842
吉林,2021,理科,248,413,34090
吉林,2021,理科,261,412,34351
吉林,2021,理科,259,411,34610
吉林,2021,理科,221,410,34831
吉林,2021,理科,269,409,35100
吉林,2021,理科,255,408,35355
吉林,2021,理科,261,407,35616
吉林,2021,理科,238,406,35854
吉林,2021,理科,256,405,36110
吉林,2021,理科,263,404,36373
吉林,2021,理科,254,403,36627
吉林,2021,理科,242,402,36869
吉林,2021,理科,274,401,37143
吉林,2021,理科,226,400,37369
吉林,2021,理科,243,399,37612
吉林,2021,理科,254,398,37866
吉林,2021,理科,240,397,38106
吉林,2021,理科,261,396,38367
吉林,2021,理科,246,395,38613
吉林,2021,理科,249,394,38862
吉林,2021,理科,225,393,39087
吉林,2021,理科,253,392,39340
吉林,2021,理科,229,391,39569
吉林,2021,理科,216,390,39785
吉林,2021,理科,280,389,40065
吉林,2021,理科,240,388,40305
吉林,2021,理科,238,387,40543
吉林,2021,理科,258,386,40801
吉林,2021,理科,253,385,41054
吉林,2021,理科,248,384,41302
吉林,2021,理科,243,383,41545
吉林,2021,理科,246,382,41791
吉林,2021,理科,243,381,42034
吉林,2021,理科,228,380,42262
吉林,2021,理科,232,379,42494
吉林,2021,理科,251,378,42745
吉林,2021,理科,226,377,42971
吉林,2021,理科,259,376,43230
吉林,2021,理科,245,375,43475
吉林,2021,理科,236,374,43711
吉林,2021,理科,245,373,43956
吉林,2021,理科,236,372,44192
吉林,2021,理科,222,371,44414
吉林,2021,理科,224,370,44638
吉林,2021,理科,237,369,44875
吉林,2021,理科,244,368,45119
吉林,2021,理科,217,367,45336
吉林,2021,理科,223,366,45559
吉林,2021,理科,220,365,45779
吉林,2021,理科,219,364,45998
吉林,2021,理科,224,363,46222
吉林,2021,理科,254,362,46476
吉林,2021,理科,235,361,46711
吉林,2021,理科,228,360,46939
吉林,2021,理科,256,359,47195
吉林,2021,理科,237,358,47432
吉林,2021,理科,237,357,47669
吉林,2021,理科,227,356,47896
吉林,2021,理科,230,355,48126
吉林,2021,理科,228,354,48354
吉林,2021,理科,233,353,48587
吉林,2021,理科,232,352,48819
吉林,2021,理科,224,351,49043
吉林,2021,理科,215,350,49258
吉林,2021,理科,219,349,49477
吉林,2021,理科,196,348,49673
吉林,2021,理科,208,347,49881
吉林,2021,理科,208,346,50089
吉林,2021,理科,223,345,50312
吉林,2021,理科,224,344,50536
吉林,2021,理科,231,343,50767
吉林,2021,理科,220,342,50987
吉林,2021,理科,223,341,51210
吉林,2021,理科,192,340,51402
吉林,2021,理科,235,339,51637
吉林,2021,理科,240,338,51877
吉林,2021,理科,199,337,52076
吉林,2021,理科,207,336,52283
吉林,2021,理科,227,335,52510
吉林,2021,理科,217,334,52727
吉林,2021,理科,181,333,52908
吉林,2021,理科,210,332,53118
吉林,2021,理科,197,331,53315
吉林,2021,理科,204,330,53519
吉林,2021,理科,226,329,53745
吉林,2021,理科,190,328,53935
吉林,2021,理科,212,327,54147
吉林,2021,理科,196,326,54343
吉林,2021,理科,198,325,54541
吉林,2021,理科,173,324,54714
吉林,2021,理科,194,323,54908
吉林,2021,理科,182,322,55090
吉林,2021,理科,174,321,55264
吉林,2021,理科,177,320,55441
吉林,2021,理科,177,319,55618
吉林,2021,理科,178,318,55796
吉林,2021,理科,158,317,55954
吉林,2021,理科,196,316,56150
吉林,2021,理科,172,315,56322
吉林,2021,理科,186,314,56508
吉林,2021,理科,187,313,56695
吉林,2021,理科,176,312,56871
吉林,2021,理科,173,311,57044
吉林,2021,理科,172,310,57216
吉林,2021,理科,176,309,57392
吉林,2021,理科,157,308,57549
吉林,2021,理科,167,307,57716
吉林,2021,理科,165,306,57881
吉林,2021,理科,150,305,58031
吉林,2021,理科,182,304,58213
吉林,2021,理科,152,303,58365
吉林,2021,理科,153,302,58518
吉林,2021,理科,151,301,58669
吉林,2021,理科,166,300,58835
吉林,2021,理科,155,299,58990
吉林,2021,理科,153,298,59143
吉林,2021,理科,112,297,59255
吉林,2021,理科,162,296,59417
吉林,2021,理科,160,295,59577
吉林,2021,理科,154,294,59731
吉林,2021,理科,161,293,59892
吉林,2021,理科,129,292,60021
吉林,2021,理科,137,291,60158
吉林,2021,理科,146,290,60304
吉林,2021,理科,147,289,60451
吉林,2021,理科,125,288,60576
吉林,2021,理科,122,287,60698
吉林,2021,理科,127,286,60825
吉林,2021,理科,163,285,60988
吉林,2021,理科,129,284,61117
吉林,2021,理科,161,283,61278
吉林,2021,理科,136,282,61414
吉林,2021,理科,132,281,61546
吉林,2021,理科,129,280,61675
吉林,2021,理科,150,279,61825
吉林,2021,理科,123,278,61948
吉林,2021,理科,131,277,62079
吉林,2021,理科,112,276,62191
吉林,2021,理科,115,275,62306
吉林,2021,理科,117,274,62423
吉林,2021,理科,110,273,62533
吉林,2021,理科,110,272,62643
吉林,2021,理科,108,271,62751
吉林,2021,理科,108,270,62859
吉林,2021,理科,96,269,62955
吉林,2021,理科,101,268,63056
吉林,2021,理科,119,267,63175
吉林,2021,理科,102,266,63277
吉林,2021,理科,84,265,63361
吉林,2021,理科,93,264,63454
吉林,2021,理科,89,263,63543
吉林,2021,理科,78,262,63621
吉林,2021,理科,98,261,63719
吉林,2021,理科,92,260,63811
吉林,2021,理科,78,259,63889
吉林,2021,理科,100,258,63989
吉林,2021,理科,101,257,64090
吉林,2021,理科,82,256,64172
吉林,2021,理科,76,255,64248
吉林,2021,理科,82,254,64330
吉林,2021,理科,98,253,64428
吉林,2021,理科,95,252,64523
吉林,2021,理科,81,251,64604
吉林,2021,理科,71,250,64675
吉林,2021,理科,77,249,64752
吉林,2021,理科,79,248,64831
吉林,2021,理科,69,247,64900
吉林,2021,理科,58,246,64958
吉林,2021,理科,64,245,65022
吉林,2021,理科,68,244,65090
吉林,2021,理科,70,243,65160
吉林,2021,理科,65,242,65225
吉林,2021,理科,56,241,65281
吉林,2021,理科,61,240,65342
吉林,2021,理科,59,239,65401
吉林,2021,理科,52,238,65453
吉林,2021,理科,66,237,65519
吉林,2021,理科,65,236,65584
吉林,2021,理科,60,235,65644
吉林,2021,理科,63,234,65707
吉林,2021,理科,59,233,65766
吉林,2021,理科,60,232,65826
吉林,2021,理科,39,231,65865
吉林,2021,理科,51,230,65916
吉林,2021,理科,56,229,65972
吉林,2021,理科,56,228,66028
吉林,2021,理科,55,227,66083
吉林,2021,理科,49,226,66132
吉林,2021,理科,53,225,66185
吉林,2021,理科,57,224,66242
吉林,2021,理科,44,223,66286
吉林,2021,理科,58,222,66344
吉林,2021,理科,48,221,66392
吉林,2021,理科,37,220,66429
吉林,2021,理科,39,219,66468
吉林,2021,理科,48,218,66516
吉林,2021,理科,40,217,66556
吉林,2021,理科,38,216,66594
吉林,2021,理科,39,215,66633
吉林,2021,理科,41,214,66674
吉林,2021,理科,29,213,66703
吉林,2021,理科,46,212,66749
吉林,2021,理科,37,211,66786
吉林,2021,理科,27,210,66813
吉林,2021,理科,32,209,66845
吉林,2021,理科,32,208,66877
吉林,2021,理科,33,207,66910
吉林,2021,理科,24,206,66934
吉林,2021,理科,36,205,66970
吉林,2021,理科,23,204,66993
吉林,2021,理科,22,203,67015
吉林,2021,理科,18,202,67033
吉林,2021,理科,27,201,67060
吉林,2021,理科,23,200,67083
吉林,2021,理科,21,199,67104
吉林,2021,理科,31,198,67135
吉林,2021,理科,16,197,67151
吉林,2021,理科,24,196,67175
吉林,2021,理科,19,195,67194
吉林,2021,理科,19,194,67213
吉林,2021,理科,27,193,67240
吉林,2021,理科,31,192,67271
吉林,2021,理科,17,191,67288
吉林,2021,理科,17,190,67305
吉林,2021,理科,26,189,67331
吉林,2021,理科,16,188,67347
吉林,2021,理科,12,187,67359
吉林,2021,理科,16,186,67375
吉林,2021,理科,16,185,67391
吉林,2021,理科,14,184,67405
吉林,2021,理科,10,183,67415
吉林,2021,理科,13,182,67428
吉林,2021,理科,21,181,67449
吉林,2021,理科,11,180,67460
吉林,2021,理科,15,179,67475
吉林,2021,理科,19,178,67494
吉林,2021,理科,12,177,67506
吉林,2021,理科,10,176,67516
吉林,2021,理科,15,175,67531
吉林,2021,理科,11,174,67542
吉林,2021,理科,5,173,67547
吉林,2021,理科,14,172,67561
吉林,2021,理科,9,171,67570
吉林,2021,理科,9,170,67579
吉林,2021,理科,16,169,67595
吉林,2021,理科,10,168,67605
吉林,2021,理科,8,167,67613
吉林,2021,理科,7,166,67620
吉林,2021,理科,6,165,67626
吉林,2021,理科,10,164,67636
吉林,2021,理科,11,163,67647
吉林,2021,理科,6,162,67653
吉林,2021,理科,1,161,67654
吉林,2021,理科,3,160,67657
吉林,2021,理科,8,159,67665
吉林,2021,理科,7,158,67672
吉林,2021,理科,9,157,67681
吉林,2021,理科,7,156,67688
吉林,2021,理科,5,155,67693
吉林,2021,理科,8,154,67701
吉林,2021,理科,3,153,67704
吉林,2021,理科,5,152,67709
吉林,2021,理科,13,151,67722
吉林,2021,理科,4,150,67726
吉林,2021,理科,9,149,67735
吉林,2021,理科,2,148,67737
吉林,2021,理科,1,147,67738
吉林,2021,理科,10,146,67748
吉林,2021,理科,4,145,67752
吉林,2021,理科,3,144,67755
吉林,2021,理科,4,143,67759
吉林,2021,理科,4,142,67763
吉林,2021,理科,4,141,67767
吉林,2021,理科,1,140,67768
吉林,2021,理科,4,139,67772
吉林,2021,理科,3,138,67775
吉林,2021,理科,2,137,67777
吉林,2021,理科,2,136,67779
吉林,2021,理科,4,135,67783
吉林,2021,理科,3,134,67786
吉林,2021,理科,2,133,67788
吉林,2021,理科,2,132,67790
吉林,2021,理科,10,131,67800
吉林,2021,理科,3,130,67803
吉林,2021,理科,2,129,67805
吉林,2021,理科,1,128,67806
吉林,2021,理科,2,127,67808
吉林,2021,理科,2,126,67810
吉林,2021,理科,1,125,67811
吉林,2021,理科,1,124,67812
吉林,2021,理科,4,123,67816
吉林,2021,理科,3,122,67819
吉林,2021,理科,2,120,67821
吉林,2021,理科,2,119,67823
吉林,2021,理科,1,118,67824
吉林,2021,理科,2,115,67826
吉林,2021,理科,2,114,67828
吉林,2021,理科,1,113,67829
吉林,2021,理科,1,112,67830
吉林,2021,理科,1,111,67831
吉林,2021,理科,1,110,67832
吉林,2021,理科,1,107,67833
吉林,2021,理科,1,106,67834
吉林,2021,理科,2,104,67836
吉林,2021,理科,1,103,67837
吉林,2021,理科,1,102,67838
吉林,2021,理科,1,99,67839
吉林,2021,理科,2,98,67841
吉林,2021,理科,1,96,67842
吉林,2021,理科,1,95,67843
吉林,2021,理科,2,94,67845
吉林,2021,理科,1,93,67846
吉林,2021,理科,1,91,67847
吉林,2021,理科,1,90,67848
吉林,2021,理科,1,87,67849
吉林,2021,理科,3,86,67852
吉林,2021,理科,1,85,67853
吉林,2021,理科,1,84,67854
吉林,2021,理科,2,83,67856
吉林,2021,理科,1,82,67857
吉林,2021,理科,1,80,67858
吉林,2021,理科,1,78,67859
吉林,2021,理科,3,77,67862
吉林,2021,理科,2,74,67864
吉林,2021,理科,1,72,67865
吉林,2021,理科,1,71,67866
吉林,2021,理科,1,70,67867
吉林,2021,理科,1,69,67868
吉林,2021,理科,1,66,67869
吉林,2021,理科,1,65,67870
吉林,2021,理科,1,64,67871
吉林,2021,理科,1,63,67872
吉林,2021,理科,1,62,67873
吉林,2021,理科,2,55,67875
吉林,2021,理科,1,47,67876
吉林,2021,理科,1,38,67877
吉林,2021,理科,1,35,67878
吉林,2021,理科,2,32,67880
吉林,2021,理科,1,29,67881
吉林,2021,理科,1,7,67882
吉林,2021,理科,1,3,67883
吉林,2021,理科,1,2,67884
吉林,2021,文科,102,626,102
吉林,2021,文科,7,625,109
吉林,2021,文科,4,624,113
吉林,2021,文科,10,623,123
吉林,2021,文科,9,622,132
吉林,2021,文科,9,621,141
吉林,2021,文科,8,620,149
吉林,2021,文科,7,619,156
吉林,2021,文科,6,618,162
吉林,2021,文科,5,617,167
吉林,2021,文科,5,616,172
吉林,2021,文科,10,615,182
吉林,2021,文科,9,614,191
吉林,2021,文科,7,613,198
吉林,2021,文科,9,612,207
吉林,2021,文科,13,611,220
吉林,2021,文科,11,610,231
吉林,2021,文科,11,609,242
吉林,2021,文科,11,608,253
吉林,2021,文科,10,607,263
吉林,2021,文科,11,606,274
吉林,2021,文科,13,605,287
吉林,2021,文科,18,604,305
吉林,2021,文科,15,603,320
吉林,2021,文科,11,602,331
吉林,2021,文科,9,601,340
吉林,2021,文科,9,600,349
吉林,2021,文科,14,599,363
吉林,2021,文科,17,598,380
吉林,2021,文科,25,597,405
吉林,2021,文科,9,596,414
吉林,2021,文科,14,595,428
吉林,2021,文科,24,594,452
吉林,2021,文科,19,593,471
吉林,2021,文科,17,592,488
吉林,2021,文科,17,591,505
吉林,2021,文科,23,590,528
吉林,2021,文科,19,589,547
吉林,2021,文科,28,588,575
吉林,2021,文科,20,587,595
吉林,2021,文科,22,586,617
吉林,2021,文科,22,585,639
吉林,2021,文科,22,584,661
吉林,2021,文科,27,583,688
吉林,2021,文科,25,582,713
吉林,2021,文科,34,581,747
吉林,2021,文科,23,580,770
吉林,2021,文科,29,579,799
吉林,2021,文科,25,578,824
吉林,2021,文科,32,577,856
吉林,2021,文科,33,576,889
吉林,2021,文科,24,575,913
吉林,2021,文科,32,574,945
吉林,2021,文科,26,573,971
吉林,2021,文科,42,572,1013
吉林,2021,文科,30,571,1043
吉林,2021,文科,22,570,1065
吉林,2021,文科,21,569,1086
吉林,2021,文科,31,568,1117
吉林,2021,文科,31,567,1148
吉林,2021,文科,36,566,1184
吉林,2021,文科,34,565,1218
吉林,2021,文科,35,564,1253
吉林,2021,文科,34,563,1287
吉林,2021,文科,46,562,1333
吉林,2021,文科,29,561,1362
吉林,2021,文科,37,560,1399
吉林,2021,文科,48,559,1447
吉林,2021,文科,45,558,1492
吉林,2021,文科,34,557,1526
吉林,2021,文科,48,556,1574
吉林,2021,文科,41,555,1615
吉林,2021,文科,33,554,1648
吉林,2021,文科,35,553,1683
吉林,2021,文科,42,552,1725
吉林,2021,文科,42,551,1767
吉林,2021,文科,34,550,1801
吉林,2021,文科,53,549,1854
吉林,2021,文科,60,548,1914
吉林,2021,文科,32,547,1946
吉林,2021,文科,57,546,2003
吉林,2021,文科,65,545,2068
吉林,2021,文科,59,544,2127
吉林,2021,文科,37,543,2164
吉林,2021,文科,43,542,2207
吉林,2021,文科,56,541,2263
吉林,2021,文科,53,540,2316
吉林,2021,文科,48,539,2364
吉林,2021,文科,48,538,2412
吉林,2021,文科,40,537,2452
吉林,2021,文科,63,536,2515
吉林,2021,文科,50,535,2565
吉林,2021,文科,65,534,2630
吉林,2021,文科,61,533,2691
吉林,2021,文科,52,532,2743
吉林,2021,文科,59,531,2802
吉林,2021,文科,66,530,2868
吉林,2021,文科,56,529,2924
吉林,2021,文科,52,528,2976
吉林,2021,文科,72,527,3048
吉林,2021,文科,56,526,3104
吉林,2021,文科,72,525,3176
吉林,2021,文科,72,524,3248
吉林,2021,文科,70,523,3318
吉林,2021,文科,56,522,3374
吉林,2021,文科,63,521,3437
吉林,2021,文科,68,520,3505
吉林,2021,文科,76,519,3581
吉林,2021,文科,79,518,3660
吉林,2021,文科,80,517,3740
吉林,2021,文科,68,516,3808
吉林,2021,文科,69,515,3877
吉林,2021,文科,98,514,3975
吉林,2021,文科,59,513,4034
吉林,2021,文科,76,512,4110
吉林,2021,文科,83,511,4193
吉林,2021,文科,74,510,4267
吉林,2021,文科,89,509,4356
吉林,2021,文科,90,508,4446
吉林,2021,文科,93,507,4539
吉林,2021,文科,80,506,4619
吉林,2021,文科,74,505,4693
吉林,2021,文科,68,504,4761
吉林,2021,文科,98,503,4859
吉林,2021,文科,87,502,4946
吉林,2021,文科,78,501,5024
吉林,2021,文科,95,500,5119
吉林,2021,文科,88,499,5207
吉林,2021,文科,73,498,5280
吉林,2021,文科,94,497,5374
吉林,2021,文科,94,496,5468
吉林,2021,文科,84,495,5552
吉林,2021,文科,83,494,5635
吉林,2021,文科,103,493,5738
吉林,2021,文科,102,492,5840
吉林,2021,文科,99,491,5939
吉林,2021,文科,80,490,6019
吉林,2021,文科,71,489,6090
吉林,2021,文科,86,488,6176
吉林,2021,文科,100,487,6276
吉林,2021,文科,85,486,6361
吉林,2021,文科,96,485,6457
吉林,2021,文科,84,484,6541
吉林,2021,文科,89,483,6630
吉林,2021,文科,100,482,6730
吉林,2021,文科,108,481,6838
吉林,2021,文科,116,480,6954
吉林,2021,文科,107,479,7061
吉林,2021,文科,108,478,7169
吉林,2021,文科,117,477,7286
吉林,2021,文科,98,476,7384
吉林,2021,文科,112,475,7496
吉林,2021,文科,101,474,7597
吉林,2021,文科,101,473,7698
吉林,2021,文科,118,472,7816
吉林,2021,文科,86,471,7902
吉林,2021,文科,101,470,8003
吉林,2021,文科,119,469,8122
吉林,2021,文科,98,468,8220
吉林,2021,文科,97,467,8317
吉林,2021,文科,105,466,8422
吉林,2021,文科,95,465,8517
吉林,2021,文科,98,464,8615
吉林,2021,文科,111,463,8726
吉林,2021,文科,114,462,8840
吉林,2021,文科,119,461,8959
吉林,2021,文科,106,460,9065
吉林,2021,文科,105,459,9170
吉林,2021,文科,106,458,9276
吉林,2021,文科,110,457,9386
吉林,2021,文科,104,456,9490
吉林,2021,文科,112,455,9602
吉林,2021,文科,125,454,9727
吉林,2021,文科,92,453,9819
吉林,2021,文科,112,452,9931
吉林,2021,文科,108,451,10039
吉林,2021,文科,139,450,10178
吉林,2021,文科,133,449,10311
吉林,2021,文科,114,448,10425
吉林,2021,文科,139,447,10564
吉林,2021,文科,111,446,10675
吉林,2021,文科,123,445,10798
吉林,2021,文科,124,444,10922
吉林,2021,文科,110,443,11032
吉林,2021,文科,112,442,11144
吉林,2021,文科,111,441,11255
吉林,2021,文科,110,440,11365
吉林,2021,文科,116,439,11481
吉林,2021,文科,116,438,11597
吉林,2021,文科,133,437,11730
吉林,2021,文科,115,436,11845
吉林,2021,文科,130,435,11975
吉林,2021,文科,156,434,12131
吉林,2021,文科,129,433,12260
吉林,2021,文科,132,432,12392
吉林,2021,文科,129,431,12521
吉林,2021,文科,136,430,12657
吉林,2021,文科,129,429,12786
吉林,2021,文科,120,428,12906
吉林,2021,文科,123,427,13029
吉林,2021,文科,116,426,13145
吉林,2021,文科,143,425,13288
吉林,2021,文科,129,424,13417
吉林,2021,文科,120,423,13537
吉林,2021,文科,126,422,13663
吉林,2021,文科,144,421,13807
吉林,2021,文科,121,420,13928
吉林,2021,文科,110,419,14038
吉林,2021,文科,115,418,14153
吉林,2021,文科,142,417,14295
吉林,2021,文科,114,416,14409
吉林,2021,文科,132,415,14541
吉林,2021,文科,111,414,14652
吉林,2021,文科,115,413,14767
吉林,2021,文科,130,412,14897
吉林,2021,文科,127,411,15024
吉林,2021,文科,117,410,15141
吉林,2021,文科,120,409,15261
吉林,2021,文科,109,408,15370
吉林,2021,文科,103,407,15473
吉林,2021,文科,127,406,15600
吉林,2021,文科,120,405,15720
吉林,2021,文科,110,404,15830
吉林,2021,文科,110,403,15940
吉林,2021,文科,124,402,16064
吉林,2021,文科,100,401,16164
吉林,2021,文科,117,400,16281
吉林,2021,文科,116,399,16397
吉林,2021,文科,138,398,16535
吉林,2021,文科,107,397,16642
吉林,2021,文科,131,396,16773
吉林,2021,文科,123,395,16896
吉林,2021,文科,103,394,16999
吉林,2021,文科,92,393,17091
吉林,2021,文科,113,392,17204
吉林,2021,文科,106,391,17310
吉林,2021,文科,116,390,17426
吉林,2021,文科,116,389,17542
吉林,2021,文科,101,388,17643
吉林,2021,文科,138,387,17781
吉林,2021,文科,106,386,17887
吉林,2021,文科,116,385,18003
吉林,2021,文科,101,384,18104
吉林,2021,文科,129,383,18233
吉林,2021,文科,110,382,18343
吉林,2021,文科,105,381,18448
吉林,2021,文科,110,380,18558
吉林,2021,文科,108,379,18666
吉林,2021,文科,124,378,18790
吉林,2021,文科,98,377,18888
吉林,2021,文科,109,376,18997
吉林,2021,文科,100,375,19097
吉林,2021,文科,116,374,19213
吉林,2021,文科,124,373,19337
吉林,2021,文科,98,372,19435
吉林,2021,文科,118,371,19553
吉林,2021,文科,103,370,19656
吉林,2021,文科,103,369,19759
吉林,2021,文科,110,368,19869
吉林,2021,文科,108,367,19977
吉林,2021,文科,110,366,20087
吉林,2021,文科,118,365,20205
吉林,2021,文科,108,364,20313
吉林,2021,文科,95,363,20408
吉林,2021,文科,104,362,20512
吉林,2021,文科,111,361,20623
吉林,2021,文科,108,360,20731
吉林,2021,文科,121,359,20852
吉林,2021,文科,94,358,20946
吉林,2021,文科,102,357,21048
吉林,2021,文科,94,356,21142
吉林,2021,文科,84,355,21226
吉林,2021,文科,104,354,21330
吉林,2021,文科,111,353,21441
吉林,2021,文科,112,352,21553
吉林,2021,文科,96,351,21649
吉林,2021,文科,100,350,21749
吉林,2021,文科,94,349,21843
吉林,2021,文科,93,348,21936
吉林,2021,文科,86,347,22022
吉林,2021,文科,100,346,22122
吉林,2021,文科,80,345,22202
吉林,2021,文科,79,344,22281
吉林,2021,文科,100,343,22381
吉林,2021,文科,77,342,22458
吉林,2021,文科,104,341,22562
吉林,2021,文科,96,340,22658
吉林,2021,文科,98,339,22756
吉林,2021,文科,74,338,22830
吉林,2021,文科,89,337,22919
吉林,2021,文科,74,336,22993
吉林,2021,文科,79,335,23072
吉林,2021,文科,89,334,23161
吉林,2021,文科,65,333,23226
吉林,2021,文科,105,332,23331
吉林,2021,文科,63,331,23394
吉林,2021,文科,87,330,23481
吉林,2021,文科,83,329,23564
吉林,2021,文科,83,328,23647
吉林,2021,文科,75,327,23722
吉林,2021,文科,75,326,23797
吉林,2021,文科,79,325,23876
吉林,2021,文科,83,324,23959
吉林,2021,文科,79,323,24038
吉林,2021,文科,82,322,24120
吉林,2021,文科,81,321,24201
吉林,2021,文科,77,320,24278
吉林,2021,文科,70,319,24348
吉林,2021,文科,73,318,24421
吉林,2021,文科,69,317,24490
吉林,2021,文科,69,316,24559
吉林,2021,文科,67,315,24626
吉林,2021,文科,69,314,24695
吉林,2021,文科,53,313,24748
吉林,2021,文科,65,312,24813
吉林,2021,文科,69,311,24882
吉林,2021,文科,79,310,24961
吉林,2021,文科,58,309,25019
吉林,2021,文科,65,308,25084
吉林,2021,文科,58,307,25142
吉林,2021,文科,62,306,25204
吉林,2021,文科,59,305,25263
吉林,2021,文科,71,304,25334
吉林,2021,文科,48,303,25382
吉林,2021,文科,47,302,25429
吉林,2021,文科,59,301,25488
吉林,2021,文科,66,300,25554
吉林,2021,文科,52,299,25606
吉林,2021,文科,48,298,25654
吉林,2021,文科,45,297,25699
吉林,2021,文科,56,296,25755
吉林,2021,文科,67,295,25822
吉林,2021,文科,62,294,25884
吉林,2021,文科,47,293,25931
吉林,2021,文科,62,292,25993
吉林,2021,文科,55,291,26048
吉林,2021,文科,57,290,26105
吉林,2021,文科,36,289,26141
吉林,2021,文科,46,288,26187
吉林,2021,文科,50,287,26237
吉林,2021,文科,43,286,26280
吉林,2021,文科,41,285,26321
吉林,2021,文科,39,284,26360
吉林,2021,文科,37,283,26397
吉林,2021,文科,52,282,26449
吉林,2021,文科,53,281,26502
吉林,2021,文科,48,280,26550
吉林,2021,文科,28,279,26578
吉林,2021,文科,48,278,26626
吉林,2021,文科,41,277,26667
吉林,2021,文科,48,276,26715
吉林,2021,文科,34,275,26749
吉林,2021,文科,36,274,26785
吉林,2021,文科,35,273,26820
吉林,2021,文科,45,272,26865
吉林,2021,文科,48,271,26913
吉林,2021,文科,39,270,26952
吉林,2021,文科,39,269,26991
吉林,2021,文科,35,268,27026
吉林,2021,文科,39,267,27065
吉林,2021,文科,34,266,27099
吉林,2021,文科,39,265,27138
吉林,2021,文科,31,264,27169
吉林,2021,文科,28,263,27197
吉林,2021,文科,33,262,27230
吉林,2021,文科,28,261,27258
吉林,2021,文科,30,260,27288
吉林,2021,文科,26,259,27314
吉林,2021,文科,20,258,27334
吉林,2021,文科,28,257,27362
吉林,2021,文科,26,256,27388
吉林,2021,文科,31,255,27419
吉林,2021,文科,33,254,27452
吉林,2021,文科,30,253,27482
吉林,2021,文科,24,252,27506
吉林,2021,文科,20,251,27526
吉林,2021,文科,17,250,27543
吉林,2021,文科,23,249,27566
吉林,2021,文科,18,248,27584
吉林,2021,文科,30,247,27614
吉林,2021,文科,25,246,27639
吉林,2021,文科,25,245,27664
吉林,2021,文科,25,244,27689
吉林,2021,文科,26,243,27715
吉林,2021,文科,21,242,27736
吉林,2021,文科,25,241,27761
吉林,2021,文科,17,240,27778
吉林,2021,文科,17,239,27795
吉林,2021,文科,24,238,27819
吉林,2021,文科,19,237,27838
吉林,2021,文科,21,236,27859
吉林,2021,文科,15,235,27874
吉林,2021,文科,19,234,27893
吉林,2021,文科,14,233,27907
吉林,2021,文科,15,232,27922
吉林,2021,文科,17,231,27939
吉林,2021,文科,16,230,27955
吉林,2021,文科,18,229,27973
吉林,2021,文科,7,228,27980
吉林,2021,文科,21,227,28001
吉林,2021,文科,12,226,28013
吉林,2021,文科,21,225,28034
吉林,2021,文科,15,224,28049
吉林,2021,文科,16,223,28065
吉林,2021,文科,12,222,28077
吉林,2021,文科,10,221,28087
吉林,2021,文科,7,220,28094
吉林,2021,文科,11,219,28105
吉林,2021,文科,11,218,28116
吉林,2021,文科,15,217,28131
吉林,2021,文科,7,216,28138
吉林,2021,文科,4,215,28142
吉林,2021,文科,14,214,28156
吉林,2021,文科,10,213,28166
吉林,2021,文科,10,212,28176
吉林,2021,文科,10,211,28186
吉林,2021,文科,12,210,28198
吉林,2021,文科,10,209,28208
吉林,2021,文科,4,208,28212
吉林,2021,文科,17,207,28229
吉林,2021,文科,10,206,28239
吉林,2021,文科,11,205,28250
吉林,2021,文科,5,204,28255
吉林,2021,文科,6,203,28261
吉林,2021,文科,7,202,28268
吉林,2021,文科,7,201,28275
吉林,2021,文科,4,200,28279
吉林,2021,文科,6,199,28285
吉林,2021,文科,12,198,28297
吉林,2021,文科,11,197,28308
吉林,2021,文科,4,196,28312
吉林,2021,文科,8,195,28320
吉林,2021,文科,10,194,28330
吉林,2021,文科,9,193,28339
吉林,2021,文科,4,192,28343
吉林,2021,文科,9,191,28352
吉林,2021,文科,4,190,28356
吉林,2021,文科,5,189,28361
吉林,2021,文科,8,188,28369
吉林,2021,文科,7,187,28376
吉林,2021,文科,4,186,28380
吉林,2021,文科,4,185,28384
吉林,2021,文科,5,184,28389
吉林,2021,文科,2,183,28391
吉林,2021,文科,5,182,28396
吉林,2021,文科,4,181,28400
吉林,2021,文科,6,180,28406
吉林,2021,文科,1,179,28407
吉林,2021,文科,4,178,28411
吉林,2021,文科,4,177,28415
吉林,2021,文科,6,176,28421
吉林,2021,文科,2,175,28423
吉林,2021,文科,2,174,28425
吉林,2021,文科,5,173,28430
吉林,2021,文科,2,172,28432
吉林,2021,文科,4,171,28436
吉林,2021,文科,5,170,28441
吉林,2021,文科,5,169,28446
吉林,2021,文科,2,168,28448
吉林,2021,文科,1,167,28449
吉林,2021,文科,7,166,28456
吉林,2021,文科,1,165,28457
吉林,2021,文科,2,164,28459
吉林,2021,文科,1,162,28460
吉林,2021,文科,1,161,28461
吉林,2021,文科,5,160,28466
吉林,2021,文科,3,159,28469
吉林,2021,文科,1,158,28470
吉林,2021,文科,3,157,28473
吉林,2021,文科,2,156,28475
吉林,2021,文科,1,155,28476
吉林,2021,文科,3,154,28479
吉林,2021,文科,1,153,28480
吉林,2021,文科,3,152,28483
吉林,2021,文科,5,151,28488
吉林,2021,文科,2,149,28490
吉林,2021,文科,1,147,28491
吉林,2021,文科,1,146,28492
吉林,2021,文科,1,145,28493
吉林,2021,文科,6,144,28499
吉林,2021,文科,4,143,28503
吉林,2021,文科,2,142,28505
吉林,2021,文科,1,141,28506
吉林,2021,文科,2,138,28508
吉林,2021,文科,2,137,28510
吉林,2021,文科,2,135,28512
吉林,2021,文科,2,134,28514
吉林,2021,文科,2,133,28516
吉林,2021,文科,1,132,28517
吉林,2021,文科,2,131,28519
吉林,2021,文科,1,129,28520
吉林,2021,文科,1,127,28521
吉林,2021,文科,1,126,28522
吉林,2021,文科,2,125,28524
吉林,2021,文科,1,123,28525
吉林,2021,文科,1,122,28526
吉林,2021,文科,2,121,28528
吉林,2021,文科,1,117,28529
吉林,2021,文科,2,113,28531
吉林,2021,文科,1,110,28532
吉林,2021,文科,2,109,28534
吉林,2021,文科,1,108,28535
吉林,2021,文科,2,106,28537
吉林,2021,文科,1,105,28538
吉林,2021,文科,3,104,28541
吉林,2021,文科,1,102,28542
吉林,2021,文科,1,98,28543
吉林,2021,文科,1,94,28544
吉林,2021,文科,2,92,28546
吉林,2021,文科,2,91,28548
吉林,2021,文科,1,89,28549
吉林,2021,文科,1,88,28550
吉林,2021,文科,1,82,28551
吉林,2021,文科,1,81,28552
吉林,2021,文科,1,78,28553
吉林,2021,文科,2,76,28555
吉林,2021,文科,1,74,28556
吉林,2021,文科,1,71,28557
吉林,2021,文科,1,68,28558
吉林,2021,文科,1,67,28559
吉林,2021,文科,3,66,28562
吉林,2021,文科,2,62,28564
吉林,2021,文科,1,61,28565
吉林,2021,文科,1,60,28566
吉林,2021,文科,1,58,28567
吉林,2021,文科,2,55,28569
吉林,2021,文科,1,52,28570
吉林,2021,文科,1,50,28571
吉林,2021,文科,1,48,28572
吉林,2021,文科,2,44,28574
吉林,2021,文科,1,40,28575
吉林,2021,文科,1,35,28576
吉林,2021,文科,1,31,28577
吉林,2021,文科,2,29,28579
吉林,2021,文科,1,28,28580
吉林,2021,文科,1,27,28581
吉林,2021,文科,1,26,28582
吉林,2021,文科,1,25,28583
吉林,2021,文科,1,17,28584
吉林,2021,文科,1,15,28585
吉林,2021,文科,1,13,28586
吉林,2021,文科,1,12,28587
吉林,2021,文科,1,10,28588
安徽,2021,理科,36,697,36
安徽,2021,理科,6,696,42
安徽,2021,理科,7,695,49
安徽,2021,理科,9,694,58
安徽,2021,理科,11,693,69
安徽,2021,理科,12,692,81
安徽,2021,理科,11,691,92
安徽,2021,理科,9,690,101
安徽,2021,理科,11,689,112
安徽,2021,理科,14,688,126
安徽,2021,理科,14,687,140
安徽,2021,理科,13,686,153
安徽,2021,理科,12,685,165
安徽,2021,理科,19,684,184
安徽,2021,理科,19,683,203
安徽,2021,理科,21,682,224
安徽,2021,理科,26,681,250
安徽,2021,理科,32,680,282
安徽,2021,理科,39,679,321
安徽,2021,理科,25,678,346
安徽,2021,理科,45,677,391
安徽,2021,理科,41,676,432
安徽,2021,理科,49,675,481
安徽,2021,理科,30,674,511
安徽,2021,理科,34,673,545
安徽,2021,理科,28,672,573
安徽,2021,理科,41,671,614
安徽,2021,理科,49,670,663
安徽,2021,理科,46,669,709
安徽,2021,理科,52,668,761
安徽,2021,理科,53,667,814
安徽,2021,理科,65,666,879
安徽,2021,理科,64,665,943
安徽,2021,理科,56,664,999
安徽,2021,理科,71,663,1070
安徽,2021,理科,72,662,1142
安徽,2021,理科,89,661,1231
安徽,2021,理科,80,660,1311
安徽,2021,理科,79,659,1390
安徽,2021,理科,94,658,1484
安徽,2021,理科,94,657,1578
安徽,2021,理科,86,656,1664
安徽,2021,理科,105,655,1769
安徽,2021,理科,98,654,1867
安徽,2021,理科,106,653,1973
安徽,2021,理科,102,652,2075
安徽,2021,理科,116,651,2191
安徽,2021,理科,109,650,2300
安徽,2021,理科,113,649,2413
安徽,2021,理科,129,648,2542
安徽,2021,理科,122,647,2664
安徽,2021,理科,140,646,2804
安徽,2021,理科,133,645,2937
安徽,2021,理科,122,644,3059
安徽,2021,理科,132,643,3191
安徽,2021,理科,181,642,3372
安徽,2021,理科,135,641,3507
安徽,2021,理科,136,640,3643
安徽,2021,理科,179,639,3822
安徽,2021,理科,151,638,3973
安徽,2021,理科,139,637,4112
安徽,2021,理科,174,636,4286
安徽,2021,理科,160,635,4446
安徽,2021,理科,199,634,4645
安徽,2021,理科,219,633,4864
安徽,2021,理科,202,632,5066
安徽,2021,理科,194,631,5260
安徽,2021,理科,192,630,5452
安徽,2021,理科,210,629,5662
安徽,2021,理科,226,628,5888
安徽,2021,理科,213,627,6101
安徽,2021,理科,238,626,6339
安徽,2021,理科,240,625,6579
安徽,2021,理科,216,624,6795
安徽,2021,理科,239,623,7034
安徽,2021,理科,236,622,7270
安徽,2021,理科,231,621,7501
安徽,2021,理科,239,620,7740
安徽,2021,理科,293,619,8033
安徽,2021,理科,289,618,8322
安徽,2021,理科,262,617,8584
安徽,2021,理科,267,616,8851
安徽,2021,理科,280,615,9131
安徽,2021,理科,268,614,9399
安徽,2021,理科,276,613,9675
安徽,2021,理科,314,612,9989
安徽,2021,理科,338,611,10327
安徽,2021,理科,301,610,10628
安徽,2021,理科,318,609,10946
安徽,2021,理科,318,608,11264
安徽,2021,理科,336,607,11600
安徽,2021,理科,334,606,11934
安徽,2021,理科,349,605,12283
安徽,2021,理科,345,604,12628
安徽,2021,理科,355,603,12983
安徽,2021,理科,385,602,13368
安徽,2021,理科,386,601,13754
安徽,2021,理科,370,600,14124
安徽,2021,理科,406,599,14530
安徽,2021,理科,398,598,14928
安徽,2021,理科,414,597,15342
安徽,2021,理科,390,596,15732
安徽,2021,理科,388,595,16120
安徽,2021,理科,393,594,16513
安徽,2021,理科,404,593,16917
安徽,2021,理科,411,592,17328
安徽,2021,理科,432,591,17760
安徽,2021,理科,410,590,18170
安徽,2021,理科,431,589,18601
安徽,2021,理科,458,588,19059
安徽,2021,理科,436,587,19495
安徽,2021,理科,451,586,19946
安徽,2021,理科,485,585,20431
安徽,2021,理科,463,584,20894
安徽,2021,理科,457,583,21351
安徽,2021,理科,485,582,21836
安徽,2021,理科,494,581,22330
安徽,2021,理科,512,580,22842
安徽,2021,理科,471,579,23313
安徽,2021,理科,512,578,23825
安徽,2021,理科,498,577,24323
安徽,2021,理科,513,576,24836
安徽,2021,理科,511,575,25347
安徽,2021,理科,574,574,25921
安徽,2021,理科,552,573,26473
安徽,2021,理科,523,572,26996
安徽,2021,理科,525,571,27521
安徽,2021,理科,533,570,28054
安徽,2021,理科,568,569,28622
安徽,2021,理科,548,568,29170
安徽,2021,理科,509,567,29679
安徽,2021,理科,584,566,30263
安徽,2021,理科,563,565,30826
安徽,2021,理科,579,564,31405
安徽,2021,理科,618,563,32023
安徽,2021,理科,584,562,32607
安徽,2021,理科,620,561,33227
安徽,2021,理科,642,560,33869
安徽,2021,理科,633,559,34502
安徽,2021,理科,612,558,35114
安徽,2021,理科,609,557,35723
安徽,2021,理科,648,556,36371
安徽,2021,理科,607,555,36978
安徽,2021,理科,620,554,37598
安徽,2021,理科,633,553,38231
安徽,2021,理科,698,552,38929
安徽,2021,理科,669,551,39598
安徽,2021,理科,711,550,40309
安徽,2021,理科,666,549,40975
安徽,2021,理科,692,548,41667
安徽,2021,理科,710,547,42377
安徽,2021,理科,667,546,43044
安徽,2021,理科,709,545,43753
安徽,2021,理科,754,544,44507
安徽,2021,理科,683,543,45190
安徽,2021,理科,660,542,45850
安徽,2021,理科,716,541,46566
安徽,2021,理科,695,540,47261
安徽,2021,理科,688,539,47949
安徽,2021,理科,697,538,48646
安徽,2021,理科,748,537,49394
安徽,2021,理科,780,536,50174
安徽,2021,理科,664,535,50838
安徽,2021,理科,778,534,51616
安徽,2021,理科,756,533,52372
安徽,2021,理科,783,532,53155
安徽,2021,理科,747,531,53902
安徽,2021,理科,723,530,54625
安徽,2021,理科,767,529,55392
安徽,2021,理科,814,528,56206
安徽,2021,理科,730,527,56936
安徽,2021,理科,788,526,57724
安徽,2021,理科,770,525,58494
安徽,2021,理科,785,524,59279
安徽,2021,理科,749,523,60028
安徽,2021,理科,835,522,60863
安徽,2021,理科,807,521,61670
安徽,2021,理科,791,520,62461
安徽,2021,理科,773,519,63234
安徽,2021,理科,802,518,64036
安徽,2021,理科,827,517,64863
安徽,2021,理科,782,516,65645
安徽,2021,理科,833,515,66478
安徽,2021,理科,864,514,67342
安徽,2021,理科,772,513,68114
安徽,2021,理科,862,512,68976
安徽,2021,理科,847,511,69823
安徽,2021,理科,830,510,70653
安徽,2021,理科,827,509,71480
安徽,2021,理科,821,508,72301
安徽,2021,理科,839,507,73140
安徽,2021,理科,860,506,74000
安徽,2021,理科,868,505,74868
安徽,2021,理科,876,504,75744
安徽,2021,理科,889,503,76633
安徽,2021,理科,853,502,77486
安徽,2021,理科,901,501,78387
安徽,2021,理科,852,500,79239
安徽,2021,理科,879,499,80118
安徽,2021,理科,816,498,80934
安徽,2021,理科,891,497,81825
安徽,2021,理科,866,496,82691
安徽,2021,理科,904,495,83595
安徽,2021,理科,873,494,84468
安徽,2021,理科,896,493,85364
安徽,2021,理科,864,492,86228
安徽,2021,理科,886,491,87114
安徽,2021,理科,940,490,88054
安徽,2021,理科,929,489,88983
安徽,2021,理科,940,488,89923
安徽,2021,理科,959,487,90882
安徽,2021,理科,916,486,91798
安徽,2021,理科,917,485,92715
安徽,2021,理科,942,484,93657
安徽,2021,理科,998,483,94655
安徽,2021,理科,942,482,95597
安徽,2021,理科,1030,481,96627
安徽,2021,理科,915,480,97542
安徽,2021,理科,946,479,98488
安徽,2021,理科,886,478,99374
安徽,2021,理科,914,477,100288
安徽,2021,理科,948,476,101236
安徽,2021,理科,952,475,102188
安徽,2021,理科,958,474,103146
安徽,2021,理科,970,473,104116
安徽,2021,理科,961,472,105077
安徽,2021,理科,935,471,106012
安徽,2021,理科,916,470,106928
安徽,2021,理科,937,469,107865
安徽,2021,理科,1000,468,108865
安徽,2021,理科,982,467,109847
安徽,2021,理科,1000,466,110847
安徽,2021,理科,917,465,111764
安徽,2021,理科,1016,464,112780
安徽,2021,理科,998,463,113778
安徽,2021,理科,921,462,114699
安徽,2021,理科,959,461,115658
安徽,2021,理科,950,460,116608
安徽,2021,理科,941,459,117549
安徽,2021,理科,1042,458,118591
安徽,2021,理科,917,457,119508
安徽,2021,理科,977,456,120485
安徽,2021,理科,941,455,121426
安徽,2021,理科,977,454,122403
安徽,2021,理科,958,453,123361
安徽,2021,理科,926,452,124287
安徽,2021,理科,1003,451,125290
安徽,2021,理科,997,450,126287
安徽,2021,理科,963,449,127250
安徽,2021,理科,986,448,128236
安徽,2021,理科,912,447,129148
安徽,2021,理科,919,446,130067
安徽,2021,理科,930,445,130997
安徽,2021,理科,961,444,131958
安徽,2021,理科,960,443,132918
安徽,2021,理科,958,442,133876
安徽,2021,理科,979,441,134855
安徽,2021,理科,908,440,135763
安徽,2021,理科,900,439,136663
安徽,2021,理科,947,438,137610
安徽,2021,理科,908,437,138518
安徽,2021,理科,854,436,139372
安徽,2021,理科,916,435,140288
安徽,2021,理科,884,434,141172
安徽,2021,理科,913,433,142085
安徽,2021,理科,811,432,142896
安徽,2021,理科,856,431,143752
安徽,2021,理科,902,430,144654
安徽,2021,理科,847,429,145501
安徽,2021,理科,922,428,146423
安徽,2021,理科,854,427,147277
安徽,2021,理科,841,426,148118
安徽,2021,理科,880,425,148998
安徽,2021,理科,867,424,149865
安徽,2021,理科,783,423,150648
安徽,2021,理科,819,422,151467
安徽,2021,理科,790,421,152257
安徽,2021,理科,826,420,153083
安徽,2021,理科,802,419,153885
安徽,2021,理科,854,418,154739
安徽,2021,理科,806,417,155545
安徽,2021,理科,833,416,156378
安徽,2021,理科,778,415,157156
安徽,2021,理科,806,414,157962
安徽,2021,理科,749,413,158711
安徽,2021,理科,748,412,159459
安徽,2021,理科,781,411,160240
安徽,2021,理科,774,410,161014
安徽,2021,理科,798,409,161812
安徽,2021,理科,722,408,162534
安徽,2021,理科,724,407,163258
安徽,2021,理科,755,406,164013
安徽,2021,理科,757,405,164770
安徽,2021,理科,665,404,165435
安徽,2021,理科,713,403,166148
安徽,2021,理科,722,402,166870
安徽,2021,理科,682,401,167552
安徽,2021,理科,697,400,168249
安徽,2021,理科,726,399,168975
安徽,2021,理科,697,398,169672
安徽,2021,理科,665,397,170337
安徽,2021,理科,673,396,171010
安徽,2021,理科,661,395,171671
安徽,2021,理科,627,394,172298
安徽,2021,理科,624,393,172922
安徽,2021,理科,683,392,173605
安徽,2021,理科,659,391,174264
安徽,2021,理科,627,390,174891
安徽,2021,理科,614,389,175505
安徽,2021,理科,645,388,176150
安徽,2021,理科,599,387,176749
安徽,2021,理科,572,386,177321
安徽,2021,理科,603,385,177924
安徽,2021,理科,605,384,178529
安徽,2021,理科,568,383,179097
安徽,2021,理科,550,382,179647
安徽,2021,理科,581,381,180228
安徽,2021,理科,585,380,180813
安徽,2021,理科,561,379,181374
安徽,2021,理科,529,378,181903
安徽,2021,理科,570,377,182473
安徽,2021,理科,560,376,183033
安徽,2021,理科,514,375,183547
安徽,2021,理科,541,374,184088
安徽,2021,理科,524,373,184612
安徽,2021,理科,479,372,185091
安徽,2021,理科,490,371,185581
安徽,2021,理科,515,370,186096
安徽,2021,理科,524,369,186620
安徽,2021,理科,535,368,187155
安徽,2021,理科,532,367,187687
安徽,2021,理科,502,366,188189
安徽,2021,理科,488,365,188677
安徽,2021,理科,490,364,189167
安徽,2021,理科,483,363,189650
安徽,2021,理科,441,362,190091
安徽,2021,理科,482,361,190573
安徽,2021,理科,442,360,191015
安徽,2021,理科,439,359,191454
安徽,2021,理科,454,358,191908
安徽,2021,理科,447,357,192355
安徽,2021,理科,455,356,192810
安徽,2021,理科,462,355,193272
安徽,2021,理科,418,354,193690
安徽,2021,理科,420,353,194110
安徽,2021,理科,436,352,194546
安徽,2021,理科,445,351,194991
安徽,2021,理科,437,350,195428
安徽,2021,理科,388,349,195816
安徽,2021,理科,407,348,196223
安徽,2021,理科,421,347,196644
安徽,2021,理科,427,346,197071
安徽,2021,理科,428,345,197499
安徽,2021,理科,374,344,197873
安徽,2021,理科,401,343,198274
安徽,2021,理科,374,342,198648
安徽,2021,理科,398,341,199046
安徽,2021,理科,380,340,199426
安徽,2021,理科,396,339,199822
安徽,2021,理科,340,338,200162
安徽,2021,理科,425,337,200587
安徽,2021,理科,378,336,200965
安徽,2021,理科,383,335,201348
安徽,2021,理科,330,334,201678
安徽,2021,理科,369,333,202047
安徽,2021,理科,370,332,202417
安徽,2021,理科,334,331,202751
安徽,2021,理科,360,330,203111
安徽,2021,理科,326,329,203437
安徽,2021,理科,318,328,203755
安徽,2021,理科,321,327,204076
安徽,2021,理科,341,326,204417
安徽,2021,理科,352,325,204769
安徽,2021,理科,339,324,205108
安徽,2021,理科,313,323,205421
安徽,2021,理科,300,322,205721
安徽,2021,理科,266,321,205987
安徽,2021,理科,297,320,206284
安徽,2021,理科,317,319,206601
安徽,2021,理科,312,318,206913
安徽,2021,理科,259,317,207172
安徽,2021,理科,287,316,207459
安徽,2021,理科,282,315,207741
安徽,2021,理科,301,314,208042
安徽,2021,理科,288,313,208330
安徽,2021,理科,295,312,208625
安徽,2021,理科,308,311,208933
安徽,2021,理科,273,310,209206
安徽,2021,理科,270,309,209476
安徽,2021,理科,263,308,209739
安徽,2021,理科,288,307,210027
安徽,2021,理科,257,306,210284
安徽,2021,理科,268,305,210552
安徽,2021,理科,258,304,210810
安徽,2021,理科,249,303,211059
安徽,2021,理科,226,302,211285
安徽,2021,理科,241,301,211526
安徽,2021,理科,246,300,211772
安徽,2021,理科,238,299,212010
安徽,2021,理科,245,298,212255
安徽,2021,理科,238,297,212493
安徽,2021,理科,236,296,212729
安徽,2021,理科,232,295,212961
安徽,2021,理科,231,294,213192
安徽,2021,理科,234,293,213426
安徽,2021,理科,218,292,213644
安徽,2021,理科,216,291,213860
安徽,2021,理科,244,290,214104
安徽,2021,理科,197,289,214301
安徽,2021,理科,241,288,214542
安徽,2021,理科,218,287,214760
安徽,2021,理科,196,286,214956
安徽,2021,理科,209,285,215165
安徽,2021,理科,231,284,215396
安徽,2021,理科,201,283,215597
安徽,2021,理科,207,282,215804
安徽,2021,理科,201,281,216005
安徽,2021,理科,176,280,216181
安徽,2021,理科,189,279,216370
安徽,2021,理科,210,278,216580
安徽,2021,理科,191,277,216771
安徽,2021,理科,190,276,216961
安徽,2021,理科,190,275,217151
安徽,2021,理科,170,274,217321
安徽,2021,理科,179,273,217500
安徽,2021,理科,179,272,217679
安徽,2021,理科,178,271,217857
安徽,2021,理科,172,270,218029
安徽,2021,理科,175,269,218204
安徽,2021,理科,175,268,218379
安徽,2021,理科,182,267,218561
安徽,2021,理科,160,266,218721
安徽,2021,理科,149,265,218870
安徽,2021,理科,174,264,219044
安徽,2021,理科,153,263,219197
安徽,2021,理科,152,262,219349
安徽,2021,理科,155,261,219504
安徽,2021,理科,158,260,219662
安徽,2021,理科,152,259,219814
安徽,2021,理科,143,258,219957
安徽,2021,理科,143,257,220100
安徽,2021,理科,136,256,220236
安徽,2021,理科,161,255,220397
安徽,2021,理科,138,254,220535
安徽,2021,理科,138,253,220673
安徽,2021,理科,135,252,220808
安徽,2021,理科,131,251,220939
安徽,2021,理科,138,250,221077
安徽,2021,理科,121,249,221198
安徽,2021,理科,132,248,221330
安徽,2021,理科,137,247,221467
安徽,2021,理科,108,246,221575
安徽,2021,理科,107,245,221682
安徽,2021,理科,130,244,221812
安徽,2021,理科,119,243,221931
安徽,2021,理科,111,242,222042
安徽,2021,理科,119,241,222161
安徽,2021,理科,109,240,222270
安徽,2021,理科,108,239,222378
安徽,2021,理科,111,238,222489
安徽,2021,理科,117,237,222606
安徽,2021,理科,114,236,222720
安徽,2021,理科,88,235,222808
安徽,2021,理科,110,234,222918
安徽,2021,理科,88,233,223006
安徽,2021,理科,109,232,223115
安徽,2021,理科,97,231,223212
安徽,2021,理科,104,230,223316
安徽,2021,理科,113,229,223429
安徽,2021,理科,102,228,223531
安徽,2021,理科,93,227,223624
安徽,2021,理科,90,226,223714
安徽,2021,理科,90,225,223804
安徽,2021,理科,82,224,223886
安徽,2021,理科,88,223,223974
安徽,2021,理科,76,222,224050
安徽,2021,理科,77,221,224127
安徽,2021,理科,69,220,224196
安徽,2021,理科,83,219,224279
安徽,2021,理科,92,218,224371
安徽,2021,理科,69,217,224440
安徽,2021,理科,79,216,224519
安徽,2021,理科,85,215,224604
安徽,2021,理科,85,214,224689
安徽,2021,理科,63,213,224752
安徽,2021,理科,62,212,224814
安徽,2021,理科,69,211,224883
安徽,2021,理科,71,210,224954
安徽,2021,理科,65,209,225019
安徽,2021,理科,71,208,225090
安徽,2021,理科,58,207,225148
安徽,2021,理科,54,206,225202
安徽,2021,理科,54,205,225256
安徽,2021,理科,57,204,225313
安徽,2021,理科,51,203,225364
安徽,2021,理科,53,202,225417
安徽,2021,理科,57,201,225474
安徽,2021,文科,35,670,35
安徽,2021,文科,1,669,36
安徽,2021,文科,3,668,39
安徽,2021,文科,4,667,43
安徽,2021,文科,6,666,49
安徽,2021,文科,8,665,57
安徽,2021,文科,8,664,65
安徽,2021,文科,10,663,75
安徽,2021,文科,10,662,85
安徽,2021,文科,9,661,94
安徽,2021,文科,20,660,114
安徽,2021,文科,20,659,134
安徽,2021,文科,15,658,149
安徽,2021,文科,26,657,175
安徽,2021,文科,22,656,197
安徽,2021,文科,29,655,226
安徽,2021,文科,30,654,256
安徽,2021,文科,24,653,280
安徽,2021,文科,20,652,300
安徽,2021,文科,31,651,331
安徽,2021,文科,22,650,353
安徽,2021,文科,25,649,378
安徽,2021,文科,29,648,407
安徽,2021,文科,31,647,438
安徽,2021,文科,41,646,479
安徽,2021,文科,40,645,519
安徽,2021,文科,55,644,574
安徽,2021,文科,32,643,606
安徽,2021,文科,55,642,661
安徽,2021,文科,43,641,704
安徽,2021,文科,56,640,760
安徽,2021,文科,59,639,819
安徽,2021,文科,64,638,883
安徽,2021,文科,55,637,938
安徽,2021,文科,70,636,1008
安徽,2021,文科,69,635,1077
安徽,2021,文科,85,634,1162
安徽,2021,文科,66,633,1228
安徽,2021,文科,73,632,1301
安徽,2021,文科,79,631,1380
安徽,2021,文科,94,630,1474
安徽,2021,文科,88,629,1562
安徽,2021,文科,108,628,1670
安徽,2021,文科,102,627,1772
安徽,2021,文科,78,626,1850
安徽,2021,文科,107,625,1957
安徽,2021,文科,114,624,2071
安徽,2021,文科,106,623,2177
安徽,2021,文科,130,622,2307
安徽,2021,文科,116,621,2423
安徽,2021,文科,139,620,2562
安徽,2021,文科,137,619,2699
安徽,2021,文科,135,618,2834
安徽,2021,文科,153,617,2987
安徽,2021,文科,151,616,3138
安徽,2021,文科,166,615,3304
安徽,2021,文科,165,614,3469
安徽,2021,文科,127,613,3596
安徽,2021,文科,191,612,3787
安徽,2021,文科,156,611,3943
安徽,2021,文科,178,610,4121
安徽,2021,文科,179,609,4300
安徽,2021,文科,192,608,4492
安徽,2021,文科,208,607,4700
安徽,2021,文科,215,606,4915
安徽,2021,文科,199,605,5114
安徽,2021,文科,190,604,5304
安徽,2021,文科,247,603,5551
安徽,2021,文科,237,602,5788
安徽,2021,文科,218,601,6006
安徽,2021,文科,214,600,6220
安徽,2021,文科,238,599,6458
安徽,2021,文科,264,598,6722
安徽,2021,文科,281,597,7003
安徽,2021,文科,270,596,7273
安徽,2021,文科,263,595,7536
安徽,2021,文科,278,594,7814
安徽,2021,文科,302,593,8116
安徽,2021,文科,276,592,8392
安徽,2021,文科,280,591,8672
安徽,2021,文科,299,590,8971
安徽,2021,文科,322,589,9293
安徽,2021,文科,307,588,9600
安徽,2021,文科,317,587,9917
安徽,2021,文科,331,586,10248
安徽,2021,文科,329,585,10577
安徽,2021,文科,353,584,10930
安徽,2021,文科,390,583,11320
安徽,2021,文科,377,582,11697
安徽,2021,文科,372,581,12069
安徽,2021,文科,410,580,12479
安徽,2021,文科,423,579,12902
安徽,2021,文科,406,578,13308
安徽,2021,文科,428,577,13736
安徽,2021,文科,412,576,14148
安徽,2021,文科,450,575,14598
安徽,2021,文科,417,574,15015
安徽,2021,文科,456,573,15471
安徽,2021,文科,446,572,15917
安徽,2021,文科,484,571,16401
安徽,2021,文科,482,570,16883
安徽,2021,文科,468,569,17351
安徽,2021,文科,499,568,17850
安徽,2021,文科,508,567,18358
安徽,2021,文科,495,566,18853
安徽,2021,文科,490,565,19343
安徽,2021,文科,599,564,19942
安徽,2021,文科,524,563,20466
安徽,2021,文科,567,562,21033
安徽,2021,文科,573,561,21606
安徽,2021,文科,576,560,22182
安徽,2021,文科,632,559,22814
安徽,2021,文科,645,558,23459
安徽,2021,文科,609,557,24068
安徽,2021,文科,659,556,24727
安徽,2021,文科,661,555,25388
安徽,2021,文科,602,554,25990
安徽,2021,文科,629,553,26619
安徽,2021,文科,670,552,27289
安徽,2021,文科,657,551,27946
安徽,2021,文科,674,550,28620
安徽,2021,文科,684,549,29304
安徽,2021,文科,693,548,29997
安徽,2021,文科,700,547,30697
安徽,2021,文科,726,546,31423
安徽,2021,文科,695,545,32118
安徽,2021,文科,736,544,32854
安徽,2021,文科,714,543,33568
安徽,2021,文科,729,542,34297
安徽,2021,文科,727,541,35024
安徽,2021,文科,749,540,35773
安徽,2021,文科,724,539,36497
安徽,2021,文科,724,538,37221
安徽,2021,文科,756,537,37977
安徽,2021,文科,742,536,38719
安徽,2021,文科,766,535,39485
安徽,2021,文科,736,534,40221
安徽,2021,文科,771,533,40992
安徽,2021,文科,770,532,41762
安徽,2021,文科,756,531,42518
安徽,2021,文科,715,530,43233
安徽,2021,文科,748,529,43981
安徽,2021,文科,815,528,44796
安徽,2021,文科,776,527,45572
安徽,2021,文科,784,526,46356
安徽,2021,文科,801,525,47157
安徽,2021,文科,827,524,47984
安徽,2021,文科,772,523,48756
安徽,2021,文科,736,522,49492
安徽,2021,文科,764,521,50256
安徽,2021,文科,767,520,51023
安徽,2021,文科,776,519,51799
安徽,2021,文科,757,518,52556
安徽,2021,文科,790,517,53346
安徽,2021,文科,712,516,54058
安徽,2021,文科,749,515,54807
安徽,2021,文科,740,514,55547
安徽,2021,文科,797,513,56344
安徽,2021,文科,774,512,57118
安徽,2021,文科,739,511,57857
安徽,2021,文科,738,510,58595
安徽,2021,文科,758,509,59353
安徽,2021,文科,730,508,60083
安徽,2021,文科,715,507,60798
安徽,2021,文科,745,506,61543
安徽,2021,文科,755,505,62298
安徽,2021,文科,667,504,62965
安徽,2021,文科,692,503,63657
安徽,2021,文科,711,502,64368
安徽,2021,文科,692,501,65060
安徽,2021,文科,732,500,65792
安徽,2021,文科,760,499,66552
安徽,2021,文科,768,498,67320
安徽,2021,文科,737,497,68057
安徽,2021,文科,745,496,68802
安徽,2021,文科,665,495,69467
安徽,2021,文科,719,494,70186
安徽,2021,文科,696,493,70882
安徽,2021,文科,708,492,71590
安徽,2021,文科,662,491,72252
安徽,2021,文科,671,490,72923
安徽,2021,文科,651,489,73574
安徽,2021,文科,655,488,74229
安徽,2021,文科,667,487,74896
安徽,2021,文科,645,486,75541
安徽,2021,文科,635,485,76176
安徽,2021,文科,690,484,76866
安徽,2021,文科,664,483,77530
安徽,2021,文科,655,482,78185
安徽,2021,文科,656,481,78841
安徽,2021,文科,605,480,79446
安徽,2021,文科,620,479,80066
安徽,2021,文科,617,478,80683
安徽,2021,文科,653,477,81336
安徽,2021,文科,572,476,81908
安徽,2021,文科,667,475,82575
安徽,2021,文科,658,474,83233
安徽,2021,文科,603,473,83836
安徽,2021,文科,602,472,84438
安徽,2021,文科,571,471,85009
安徽,2021,文科,540,470,85549
安徽,2021,文科,609,469,86158
安徽,2021,文科,603,468,86761
安徽,2021,文科,587,467,87348
安徽,2021,文科,576,466,87924
安徽,2021,文科,598,465,88522
安徽,2021,文科,510,464,89032
安徽,2021,文科,592,463,89624
安徽,2021,文科,563,462,90187
安徽,2021,文科,597,461,90784
安徽,2021,文科,590,460,91374
安徽,2021,文科,579,459,91953
安徽,2021,文科,596,458,92549
安徽,2021,文科,594,457,93143
安徽,2021,文科,564,456,93707
安徽,2021,文科,558,455,94265
安徽,2021,文科,575,454,94840
安徽,2021,文科,559,453,95399
安徽,2021,文科,575,452,95974
安徽,2021,文科,553,451,96527
安徽,2021,文科,535,450,97062
安徽,2021,文科,504,449,97566
安徽,2021,文科,537,448,98103
安徽,2021,文科,532,447,98635
安徽,2021,文科,607,446,99242
安徽,2021,文科,527,445,99769
安徽,2021,文科,542,444,100311
安徽,2021,文科,565,443,100876
安徽,2021,文科,554,442,101430
安徽,2021,文科,548,441,101978
安徽,2021,文科,571,440,102549
安徽,2021,文科,565,439,103114
安徽,2021,文科,568,438,103682
安徽,2021,文科,567,437,104249
安徽,2021,文科,559,436,104808
安徽,2021,文科,568,435,105376
安徽,2021,文科,550,434,105926
安徽,2021,文科,585,433,106511
安徽,2021,文科,571,432,107082
安徽,2021,文科,532,431,107614
安徽,2021,文科,567,430,108181
安徽,2021,文科,568,429,108749
安徽,2021,文科,539,428,109288
安徽,2021,文科,586,427,109874
安徽,2021,文科,604,426,110478
安徽,2021,文科,610,425,111088
安徽,2021,文科,539,424,111627
安徽,2021,文科,546,423,112173
安徽,2021,文科,597,422,112770
安徽,2021,文科,569,421,113339
安徽,2021,文科,557,420,113896
安徽,2021,文科,519,419,114415
安徽,2021,文科,550,418,114965
安徽,2021,文科,553,417,115518
安徽,2021,文科,591,416,116109
安徽,2021,文科,597,415,116706
安徽,2021,文科,559,414,117265
安徽,2021,文科,532,413,117797
安徽,2021,文科,582,412,118379
安徽,2021,文科,560,411,118939
安徽,2021,文科,502,410,119441
安徽,2021,文科,540,409,119981
安徽,2021,文科,538,408,120519
安徽,2021,文科,534,407,121053
安徽,2021,文科,598,406,121651
安徽,2021,文科,536,405,122187
安徽,2021,文科,604,404,122791
安徽,2021,文科,543,403,123334
安徽,2021,文科,626,402,123960
安徽,2021,文科,622,401,124582
安徽,2021,文科,509,400,125091
安徽,2021,文科,535,399,125626
安徽,2021,文科,559,398,126185
安徽,2021,文科,536,397,126721
安徽,2021,文科,579,396,127300
安徽,2021,文科,550,395,127850
安徽,2021,文科,521,394,128371
安徽,2021,文科,558,393,128929
安徽,2021,文科,569,392,129498
安徽,2021,文科,546,391,130044
安徽,2021,文科,593,390,130637
安徽,2021,文科,526,389,131163
安徽,2021,文科,587,388,131750
安徽,2021,文科,571,387,132321
安徽,2021,文科,566,386,132887
安徽,2021,文科,611,385,133498
安徽,2021,文科,570,384,134068
安徽,2021,文科,585,383,134653
安徽,2021,文科,505,382,135158
安徽,2021,文科,573,381,135731
安徽,2021,文科,520,380,136251
安徽,2021,文科,515,379,136766
安徽,2021,文科,582,378,137348
安徽,2021,文科,548,377,137896
安徽,2021,文科,575,376,138471
安徽,2021,文科,546,375,139017
安徽,2021,文科,528,374,139545
安徽,2021,文科,512,373,140057
安徽,2021,文科,545,372,140602
安徽,2021,文科,573,371,141175
安徽,2021,文科,529,370,141704
安徽,2021,文科,518,369,142222
安徽,2021,文科,538,368,142760
安徽,2021,文科,554,367,143314
安徽,2021,文科,534,366,143848
安徽,2021,文科,544,365,144392
安徽,2021,文科,567,364,144959
安徽,2021,文科,533,363,145492
安徽,2021,文科,533,362,146025
安徽,2021,文科,500,361,146525
安徽,2021,文科,502,360,147027
安徽,2021,文科,537,359,147564
安徽,2021,文科,522,358,148086
安徽,2021,文科,558,357,148644
安徽,2021,文科,475,356,149119
安徽,2021,文科,513,355,149632
安徽,2021,文科,483,354,150115
安徽,2021,文科,495,353,150610
安徽,2021,文科,490,352,151100
安徽,2021,文科,496,351,151596
安徽,2021,文科,499,350,152095
安徽,2021,文科,461,349,152556
安徽,2021,文科,507,348,153063
安徽,2021,文科,436,347,153499
安徽,2021,文科,463,346,153962
安徽,2021,文科,524,345,154486
安徽,2021,文科,468,344,154954
安徽,2021,文科,436,343,155390
安徽,2021,文科,476,342,155866
安徽,2021,文科,483,341,156349
安徽,2021,文科,442,340,156791
安徽,2021,文科,451,339,157242
安徽,2021,文科,443,338,157685
安徽,2021,文科,429,337,158114
安徽,2021,文科,464,336,158578
安徽,2021,文科,435,335,159013
安徽,2021,文科,436,334,159449
安徽,2021,文科,401,333,159850
安徽,2021,文科,420,332,160270
安徽,2021,文科,436,331,160706
安徽,2021,文科,401,330,161107
安徽,2021,文科,414,329,161521
安徽,2021,文科,385,328,161906
安徽,2021,文科,411,327,162317
安徽,2021,文科,409,326,162726
安徽,2021,文科,410,325,163136
安徽,2021,文科,406,324,163542
安徽,2021,文科,372,323,163914
安徽,2021,文科,342,322,164256
安徽,2021,文科,385,321,164641
安徽,2021,文科,345,320,164986
安徽,2021,文科,362,319,165348
安徽,2021,文科,340,318,165688
安徽,2021,文科,359,317,166047
安徽,2021,文科,334,316,166381
安徽,2021,文科,349,315,166730
安徽,2021,文科,342,314,167072
安徽,2021,文科,347,313,167419
安徽,2021,文科,289,312,167708
安徽,2021,文科,334,311,168042
安徽,2021,文科,331,310,168373
安徽,2021,文科,311,309,168684
安徽,2021,文科,270,308,168954
安徽,2021,文科,315,307,169269
安徽,2021,文科,323,306,169592
安徽,2021,文科,270,305,169862
安徽,2021,文科,298,304,170160
安徽,2021,文科,285,303,170445
安徽,2021,文科,276,302,170721
安徽,2021,文科,295,301,171016
安徽,2021,文科,293,300,171309
安徽,2021,文科,285,299,171594
安徽,2021,文科,268,298,171862
安徽,2021,文科,296,297,172158
安徽,2021,文科,280,296,172438
安徽,2021,文科,264,295,172702
安徽,2021,文科,254,294,172956
安徽,2021,文科,297,293,173253
安徽,2021,文科,268,292,173521
安徽,2021,文科,257,291,173778
安徽,2021,文科,246,290,174024
安徽,2021,文科,246,289,174270
安徽,2021,文科,210,288,174480
安徽,2021,文科,231,287,174711
安徽,2021,文科,229,286,174940
安徽,2021,文科,230,285,175170
安徽,2021,文科,198,284,175368
安徽,2021,文科,221,283,175589
安徽,2021,文科,213,282,175802
安徽,2021,文科,230,281,176032
安徽,2021,文科,168,280,176200
安徽,2021,文科,222,279,176422
安徽,2021,文科,189,278,176611
安徽,2021,文科,209,277,176820
安徽,2021,文科,193,276,177013
安徽,2021,文科,203,275,177216
安徽,2021,文科,177,274,177393
安徽,2021,文科,167,273,177560
安徽,2021,文科,154,272,177714
安徽,2021,文科,172,271,177886
安徽,2021,文科,174,270,178060
安徽,2021,文科,145,269,178205
安徽,2021,文科,161,268,178366
安徽,2021,文科,151,267,178517
安徽,2021,文科,154,266,178671
安徽,2021,文科,143,265,178814
安徽,2021,文科,159,264,178973
安徽,2021,文科,146,263,179119
安徽,2021,文科,148,262,179267
安徽,2021,文科,131,261,179398
安徽,2021,文科,132,260,179530
安徽,2021,文科,125,259,179655
安徽,2021,文科,130,258,179785
安徽,2021,文科,110,257,179895
安徽,2021,文科,111,256,180006
安徽,2021,文科,103,255,180109
安徽,2021,文科,121,254,180230
安徽,2021,文科,108,253,180338
安徽,2021,文科,98,252,180436
安徽,2021,文科,99,251,180535
安徽,2021,文科,96,250,180631
安徽,2021,文科,105,249,180736
安徽,2021,文科,92,248,180828
安徽,2021,文科,95,247,180923
安徽,2021,文科,89,246,181012
安徽,2021,文科,92,245,181104
安徽,2021,文科,106,244,181210
安徽,2021,文科,98,243,181308
安徽,2021,文科,89,242,181397
安徽,2021,文科,92,241,181489
安徽,2021,文科,80,240,181569
安徽,2021,文科,71,239,181640
安徽,2021,文科,79,238,181719
安徽,2021,文科,74,237,181793
安徽,2021,文科,69,236,181862
安徽,2021,文科,55,235,181917
安徽,2021,文科,68,234,181985
安徽,2021,文科,72,233,182057
安徽,2021,文科,68,232,182125
安徽,2021,文科,60,231,182185
安徽,2021,文科,70,230,182255
安徽,2021,文科,60,229,182315
安徽,2021,文科,61,228,182376
安徽,2021,文科,67,227,182443
安徽,2021,文科,54,226,182497
安徽,2021,文科,52,225,182549
安徽,2021,文科,45,224,182594
安徽,2021,文科,54,223,182648
安徽,2021,文科,68,222,182716
安徽,2021,文科,51,221,182767
安徽,2021,文科,39,220,182806
安徽,2021,文科,40,219,182846
安徽,2021,文科,41,218,182887
安徽,2021,文科,41,217,182928
安徽,2021,文科,48,216,182976
安徽,2021,文科,50,215,183026
安徽,2021,文科,40,214,183066
安徽,2021,文科,31,213,183097
安徽,2021,文科,34,212,183131
安徽,2021,文科,34,211,183165
安徽,2021,文科,34,210,183199
安徽,2021,文科,43,209,183242
安徽,2021,文科,23,208,183265
安徽,2021,文科,39,207,183304
安徽,2021,文科,39,206,183343
安徽,2021,文科,29,205,183372
安徽,2021,文科,48,204,183420
安徽,2021,文科,34,203,183454
安徽,2021,文科,24,202,183478
安徽,2021,文科,30,201,183508
四川,2021,理科,49,700,49
四川,2021,理科,7,699,56
四川,2021,理科,5,698,61
四川,2021,理科,12,697,73
四川,2021,理科,15,696,88
四川,2021,理科,8,695,96
四川,2021,理科,8,694,104
四川,2021,理科,18,693,122
四川,2021,理科,28,692,150
四川,2021,理科,13,691,163
四川,2021,理科,14,690,177
四川,2021,理科,27,689,204
四川,2021,理科,22,688,226
四川,2021,理科,27,687,253
四川,2021,理科,38,686,291
四川,2021,理科,32,685,323
四川,2021,理科,27,684,350
四川,2021,理科,41,683,391
四川,2021,理科,45,682,436
四川,2021,理科,33,681,469
四川,2021,理科,42,680,511
四川,2021,理科,67,679,578
四川,2021,理科,51,678,629
四川,2021,理科,60,677,689
四川,2021,理科,53,676,742
四川,2021,理科,61,675,803
四川,2021,理科,60,674,863
四川,2021,理科,57,673,920
四川,2021,理科,73,672,993
四川,2021,理科,85,671,1078
四川,2021,理科,69,670,1147
四川,2021,理科,76,669,1223
四川,2021,理科,80,668,1303
四川,2021,理科,76,667,1379
四川,2021,理科,96,666,1475
四川,2021,理科,75,665,1550
四川,2021,理科,100,664,1650
四川,2021,理科,104,663,1754
四川,2021,理科,115,662,1869
四川,2021,理科,113,661,1982
四川,2021,理科,135,660,2117
四川,2021,理科,114,659,2231
四川,2021,理科,119,658,2350
四川,2021,理科,105,657,2455
四川,2021,理科,145,656,2600
四川,2021,理科,130,655,2730
四川,2021,理科,148,654,2878
四川,2021,理科,156,653,3034
四川,2021,理科,155,652,3189
四川,2021,理科,146,651,3335
四川,2021,理科,162,650,3497
四川,2021,理科,163,649,3660
四川,2021,理科,192,648,3852
四川,2021,理科,194,647,4046
四川,2021,理科,180,646,4226
四川,2021,理科,185,645,4411
四川,2021,理科,217,644,4628
四川,2021,理科,186,643,4814
四川,2021,理科,222,642,5036
四川,2021,理科,200,641,5236
四川,2021,理科,219,640,5455
四川,2021,理科,245,639,5700
四川,2021,理科,252,638,5952
四川,2021,理科,252,637,6204
四川,2021,理科,233,636,6437
四川,2021,理科,235,635,6672
四川,2021,理科,264,634,6936
四川,2021,理科,290,633,7226
四川,2021,理科,322,632,7548
四川,2021,理科,295,631,7843
四川,2021,理科,302,630,8145
四川,2021,理科,325,629,8470
四川,2021,理科,302,628,8772
四川,2021,理科,331,627,9103
四川,2021,理科,311,626,9414
四川,2021,理科,347,625,9761
四川,2021,理科,340,624,10101
四川,2021,理科,329,623,10430
四川,2021,理科,341,622,10771
四川,2021,理科,369,621,11140
四川,2021,理科,383,620,11523
四川,2021,理科,401,619,11924
四川,2021,理科,367,618,12291
四川,2021,理科,389,617,12680
四川,2021,理科,377,616,13057
四川,2021,理科,413,615,13470
四川,2021,理科,420,614,13890
四川,2021,理科,407,613,14297
四川,2021,理科,409,612,14706
四川,2021,理科,445,611,15151
四川,2021,理科,477,610,15628
四川,2021,理科,470,609,16098
四川,2021,理科,424,608,16522
四川,2021,理科,469,607,16991
四川,2021,理科,472,606,17463
四川,2021,理科,520,605,17983
四川,2021,理科,519,604,18502
四川,2021,理科,493,603,18995
四川,2021,理科,562,602,19557
四川,2021,理科,554,601,20111
四川,2021,理科,520,600,20631
四川,2021,理科,521,599,21152
四川,2021,理科,543,598,21695
四川,2021,理科,553,597,22248
四川,2021,理科,571,596,22819
四川,2021,理科,529,595,23348
四川,2021,理科,555,594,23903
四川,2021,理科,538,593,24441
四川,2021,理科,581,592,25022
四川,2021,理科,601,591,25623
四川,2021,理科,533,590,26156
四川,2021,理科,567,589,26723
四川,2021,理科,634,588,27357
四川,2021,理科,599,587,27956
四川,2021,理科,590,586,28546
四川,2021,理科,587,585,29133
四川,2021,理科,664,584,29797
四川,2021,理科,672,583,30469
四川,2021,理科,678,582,31147
四川,2021,理科,711,581,31858
四川,2021,理科,647,580,32505
四川,2021,理科,664,579,33169
四川,2021,理科,707,578,33876
四川,2021,理科,682,577,34558
四川,2021,理科,682,576,35240
四川,2021,理科,714,575,35954
四川,2021,理科,709,574,36663
四川,2021,理科,694,573,37357
四川,2021,理科,736,572,38093
四川,2021,理科,736,571,38829
四川,2021,理科,732,570,39561
四川,2021,理科,744,569,40305
四川,2021,理科,720,568,41025
四川,2021,理科,756,567,41781
四川,2021,理科,764,566,42545
四川,2021,理科,845,565,43390
四川,2021,理科,745,564,44135
四川,2021,理科,829,563,44964
四川,2021,理科,737,562,45701
四川,2021,理科,799,561,46500
四川,2021,理科,798,560,47298
四川,2021,理科,848,559,48146
四川,2021,理科,823,558,48969
四川,2021,理科,821,557,49790
四川,2021,理科,816,556,50606
四川,2021,理科,805,555,51411
四川,2021,理科,854,554,52265
四川,2021,理科,865,553,53130
四川,2021,理科,851,552,53981
四川,2021,理科,853,551,54834
四川,2021,理科,850,550,55684
四川,2021,理科,871,549,56555
四川,2021,理科,924,548,57479
四川,2021,理科,827,547,58306
四川,2021,理科,868,546,59174
四川,2021,理科,924,545,60098
四川,2021,理科,874,544,60972
四川,2021,理科,922,543,61894
四川,2021,理科,925,542,62819
四川,2021,理科,926,541,63745
四川,2021,理科,883,540,64628
四川,2021,理科,981,539,65609
四川,2021,理科,881,538,66490
四川,2021,理科,914,537,67404
四川,2021,理科,923,536,68327
四川,2021,理科,863,535,69190
四川,2021,理科,963,534,70153
四川,2021,理科,969,533,71122
四川,2021,理科,1013,532,72135
四川,2021,理科,1026,531,73161
四川,2021,理科,957,530,74118
四川,2021,理科,933,529,75051
四川,2021,理科,954,528,76005
四川,2021,理科,901,527,76906
四川,2021,理科,982,526,77888
四川,2021,理科,1013,525,78901
四川,2021,理科,996,524,79897
四川,2021,理科,1045,523,80942
四川,2021,理科,1053,522,81995
四川,2021,理科,999,521,82994
四川,2021,理科,984,520,83978
四川,2021,理科,1014,519,84992
四川,2021,理科,982,518,85974
四川,2021,理科,1029,517,87003
四川,2021,理科,957,516,87960
四川,2021,理科,1042,515,89002
四川,2021,理科,1014,514,90016
四川,2021,理科,1043,513,91059
四川,2021,理科,1020,512,92079
四川,2021,理科,1028,511,93107
四川,2021,理科,1047,510,94154
四川,2021,理科,1067,509,95221
四川,2021,理科,1011,508,96232
四川,2021,理科,1018,507,97250
四川,2021,理科,1086,506,98336
四川,2021,理科,1064,505,99400
四川,2021,理科,1062,504,100462
四川,2021,理科,1034,503,101496
四川,2021,理科,1068,502,102564
四川,2021,理科,1088,501,103652
四川,2021,理科,1065,500,104717
四川,2021,理科,1024,499,105741
四川,2021,理科,1084,498,106825
四川,2021,理科,1027,497,107852
四川,2021,理科,1047,496,108899
四川,2021,理科,1130,495,110029
四川,2021,理科,1059,494,111088
四川,2021,理科,1120,493,112208
四川,2021,理科,1026,492,113234
四川,2021,理科,1042,491,114276
四川,2021,理科,1101,490,115377
四川,2021,理科,1043,489,116420
四川,2021,理科,1090,488,117510
四川,2021,理科,1107,487,118617
四川,2021,理科,1056,486,119673
四川,2021,理科,1097,485,120770
四川,2021,理科,1104,484,121874
四川,2021,理科,1068,483,122942
四川,2021,理科,1045,482,123987
四川,2021,理科,1064,481,125051
四川,2021,理科,1080,480,126131
四川,2021,理科,1112,479,127243
四川,2021,理科,1127,478,128370
四川,2021,理科,1051,477,129421
四川,2021,理科,1086,476,130507
四川,2021,理科,1060,475,131567
四川,2021,理科,1084,474,132651
四川,2021,理科,1095,473,133746
四川,2021,理科,1054,472,134800
四川,2021,理科,1076,471,135876
四川,2021,理科,1064,470,136940
四川,2021,理科,1116,469,138056
四川,2021,理科,1102,468,139158
四川,2021,理科,1048,467,140206
四川,2021,理科,1048,466,141254
四川,2021,理科,1130,465,142384
四川,2021,理科,1061,464,143445
四川,2021,理科,1046,463,144491
四川,2021,理科,1091,462,145582
四川,2021,理科,1030,461,146612
四川,2021,理科,1026,460,147638
四川,2021,理科,1034,459,148672
四川,2021,理科,1042,458,149714
四川,2021,理科,1032,457,150746
四川,2021,理科,1043,456,151789
四川,2021,理科,950,455,152739
四川,2021,理科,984,454,153723
四川,2021,理科,1064,453,154787
四川,2021,理科,975,452,155762
四川,2021,理科,992,451,156754
四川,2021,理科,985,450,157739
四川,2021,理科,994,449,158733
四川,2021,理科,961,448,159694
四川,2021,理科,931,447,160625
四川,2021,理科,997,446,161622
四川,2021,理科,984,445,162606
四川,2021,理科,905,444,163511
四川,2021,理科,945,443,164456
四川,2021,理科,994,442,165450
四川,2021,理科,978,441,166428
四川,2021,理科,937,440,167365
四川,2021,理科,904,439,168269
四川,2021,理科,906,438,169175
四川,2021,理科,926,437,170101
四川,2021,理科,914,436,171015
四川,2021,理科,924,435,171939
四川,2021,理科,885,434,172824
四川,2021,理科,874,433,173698
四川,2021,理科,865,432,174563
四川,2021,理科,870,431,175433
四川,2021,理科,893,430,176326
四川,2021,理科,830,429,177156
四川,2021,理科,758,428,177914
四川,2021,理科,855,427,178769
四川,2021,理科,827,426,179596
四川,2021,理科,792,425,180388
四川,2021,理科,848,424,181236
四川,2021,理科,830,423,182066
四川,2021,理科,787,422,182853
四川,2021,理科,849,421,183702
四川,2021,理科,779,420,184481
四川,2021,理科,691,419,185172
四川,2021,理科,809,418,185981
四川,2021,理科,756,417,186737
四川,2021,理科,765,416,187502
四川,2021,理科,830,415,188332
四川,2021,理科,725,414,189057
四川,2021,理科,767,413,189824
四川,2021,理科,785,412,190609
四川,2021,理科,761,411,191370
四川,2021,理科,777,410,192147
四川,2021,理科,747,409,192894
四川,2021,理科,734,408,193628
四川,2021,理科,729,407,194357
四川,2021,理科,721,406,195078
四川,2021,理科,672,405,195750
四川,2021,理科,663,404,196413
四川,2021,理科,669,403,197082
四川,2021,理科,693,402,197775
四川,2021,理科,682,401,198457
四川,2021,理科,680,400,199137
四川,2021,理科,656,399,199793
四川,2021,理科,671,398,200464
四川,2021,理科,625,397,201089
四川,2021,理科,696,396,201785
四川,2021,理科,571,395,202356
四川,2021,理科,645,394,203001
四川,2021,理科,636,393,203637
四川,2021,理科,630,392,204267
四川,2021,理科,551,391,204818
四川,2021,理科,631,390,205449
四川,2021,理科,603,389,206052
四川,2021,理科,604,388,206656
四川,2021,理科,617,387,207273
四川,2021,理科,557,386,207830
四川,2021,理科,636,385,208466
四川,2021,理科,551,384,209017
四川,2021,理科,535,383,209552
四川,2021,理科,528,382,210080
四川,2021,理科,501,381,210581
四川,2021,理科,552,380,211133
四川,2021,理科,527,379,211660
四川,2021,理科,532,378,212192
四川,2021,理科,504,377,212696
四川,2021,理科,542,376,213238
四川,2021,理科,535,375,213773
四川,2021,理科,494,374,214267
四川,2021,理科,488,373,214755
四川,2021,理科,481,372,215236
四川,2021,理科,528,371,215764
四川,2021,理科,506,370,216270
四川,2021,理科,478,369,216748
四川,2021,理科,472,368,217220
四川,2021,理科,485,367,217705
四川,2021,理科,402,366,218107
四川,2021,理科,483,365,218590
四川,2021,理科,492,364,219082
四川,2021,理科,452,363,219534
四川,2021,理科,432,362,219966
四川,2021,理科,446,361,220412
四川,2021,理科,494,360,220906
四川,2021,理科,460,359,221366
四川,2021,理科,467,358,221833
四川,2021,理科,439,357,222272
四川,2021,理科,398,356,222670
四川,2021,理科,398,355,223068
四川,2021,理科,412,354,223480
四川,2021,理科,403,353,223883
四川,2021,理科,438,352,224321
四川,2021,理科,371,351,224692
四川,2021,理科,444,350,225136
四川,2021,理科,390,349,225526
四川,2021,理科,410,348,225936
四川,2021,理科,410,347,226346
四川,2021,理科,380,346,226726
四川,2021,理科,385,345,227111
四川,2021,理科,391,344,227502
四川,2021,理科,395,343,227897
四川,2021,理科,388,342,228285
四川,2021,理科,400,341,228685
四川,2021,理科,341,340,229026
四川,2021,理科,399,339,229425
四川,2021,理科,371,338,229796
四川,2021,理科,373,337,230169
四川,2021,理科,376,336,230545
四川,2021,理科,347,335,230892
四川,2021,理科,338,334,231230
四川,2021,理科,348,333,231578
四川,2021,理科,312,332,231890
四川,2021,理科,338,331,232228
四川,2021,理科,348,330,232576
四川,2021,理科,340,329,232916
四川,2021,理科,302,328,233218
四川,2021,理科,320,327,233538
四川,2021,理科,310,326,233848
四川,2021,理科,269,325,234117
四川,2021,理科,360,324,234477
四川,2021,理科,302,323,234779
四川,2021,理科,325,322,235104
四川,2021,理科,278,321,235382
四川,2021,理科,308,320,235690
四川,2021,理科,275,319,235965
四川,2021,理科,284,318,236249
四川,2021,理科,297,317,236546
四川,2021,理科,293,316,236839
四川,2021,理科,271,315,237110
四川,2021,理科,255,314,237365
四川,2021,理科,287,313,237652
四川,2021,理科,277,312,237929
四川,2021,理科,269,311,238198
四川,2021,理科,260,310,238458
四川,2021,理科,265,309,238723
四川,2021,理科,266,308,238989
四川,2021,理科,237,307,239226
四川,2021,理科,263,306,239489
四川,2021,理科,257,305,239746
四川,2021,理科,258,304,240004
四川,2021,理科,254,303,240258
四川,2021,理科,272,302,240530
四川,2021,理科,256,301,240786
四川,2021,理科,244,300,241030
四川,2021,理科,226,299,241256
四川,2021,理科,218,298,241474
四川,2021,理科,215,297,241689
四川,2021,理科,216,296,241905
四川,2021,理科,236,295,242141
四川,2021,理科,234,294,242375
四川,2021,理科,272,293,242647
四川,2021,理科,260,292,242907
四川,2021,理科,227,291,243134
四川,2021,理科,211,290,243345
四川,2021,理科,246,289,243591
四川,2021,理科,208,288,243799
四川,2021,理科,201,287,244000
四川,2021,理科,225,286,244225
四川,2021,理科,202,285,244427
四川,2021,理科,207,284,244634
四川,2021,理科,201,283,244835
四川,2021,理科,197,282,245032
四川,2021,理科,213,281,245245
四川,2021,理科,210,280,245455
四川,2021,理科,197,279,245652
四川,2021,理科,199,278,245851
四川,2021,理科,193,277,246044
四川,2021,理科,206,276,246250
四川,2021,理科,198,275,246448
四川,2021,理科,190,274,246638
四川,2021,理科,199,273,246837
四川,2021,理科,184,272,247021
四川,2021,理科,186,271,247207
四川,2021,理科,160,270,247367
四川,2021,理科,182,269,247549
四川,2021,理科,169,268,247718
四川,2021,理科,174,267,247892
四川,2021,理科,164,266,248056
四川,2021,理科,181,265,248237
四川,2021,理科,170,264,248407
四川,2021,理科,172,263,248579
四川,2021,理科,162,262,248741
四川,2021,理科,169,261,248910
四川,2021,理科,163,260,249073
四川,2021,理科,143,259,249216
四川,2021,理科,147,258,249363
四川,2021,理科,162,257,249525
四川,2021,理科,164,256,249689
四川,2021,理科,155,255,249844
四川,2021,理科,174,254,250018
四川,2021,理科,158,253,250176
四川,2021,理科,149,252,250325
四川,2021,理科,141,251,250466
四川,2021,理科,154,250,250620
四川,2021,理科,162,249,250782
四川,2021,理科,141,248,250923
四川,2021,理科,148,247,251071
四川,2021,理科,140,246,251211
四川,2021,理科,138,245,251349
四川,2021,理科,130,244,251479
四川,2021,理科,143,243,251622
四川,2021,理科,143,242,251765
四川,2021,理科,128,241,251893
四川,2021,理科,122,240,252015
四川,2021,理科,152,239,252167
四川,2021,理科,143,238,252310
四川,2021,理科,124,237,252434
四川,2021,理科,144,236,252578
四川,2021,理科,125,235,252703
四川,2021,理科,125,234,252828
四川,2021,理科,124,233,252952
四川,2021,理科,112,232,253064
四川,2021,理科,125,231,253189
四川,2021,理科,134,230,253323
四川,2021,理科,118,229,253441
四川,2021,理科,125,228,253566
四川,2021,理科,115,227,253681
四川,2021,理科,100,226,253781
四川,2021,理科,115,225,253896
四川,2021,理科,141,224,254037
四川,2021,理科,123,223,254160
四川,2021,理科,101,222,254261
四川,2021,理科,103,221,254364
四川,2021,理科,105,220,254469
四川,2021,理科,93,219,254562
四川,2021,理科,106,218,254668
四川,2021,理科,117,217,254785
四川,2021,理科,79,216,254864
四川,2021,理科,83,215,254947
四川,2021,理科,105,214,255052
四川,2021,理科,103,213,255155
四川,2021,理科,79,212,255234
四川,2021,理科,105,211,255339
四川,2021,理科,90,210,255429
四川,2021,理科,76,209,255505
四川,2021,理科,78,208,255583
四川,2021,理科,75,207,255658
四川,2021,理科,83,206,255741
四川,2021,理科,79,205,255820
四川,2021,理科,84,204,255904
四川,2021,理科,77,203,255981
四川,2021,理科,77,202,256058
四川,2021,理科,86,201,256144
四川,2021,理科,79,200,256223
四川,2021,理科,72,199,256295
四川,2021,理科,76,198,256371
四川,2021,理科,81,197,256452
四川,2021,理科,71,196,256523
四川,2021,理科,68,195,256591
四川,2021,理科,70,194,256661
四川,2021,理科,65,193,256726
四川,2021,理科,79,192,256805
四川,2021,理科,53,191,256858
四川,2021,理科,79,190,256937
四川,2021,理科,69,189,257006
四川,2021,理科,50,188,257056
四川,2021,理科,64,187,257120
四川,2021,理科,62,186,257182
四川,2021,理科,48,185,257230
四川,2021,理科,51,184,257281
四川,2021,理科,51,183,257332
四川,2021,理科,59,182,257391
四川,2021,理科,43,181,257434
四川,2021,理科,49,180,257483
四川,2021,理科,45,179,257528
四川,2021,理科,48,178,257576
四川,2021,理科,42,177,257618
四川,2021,理科,51,176,257669
四川,2021,理科,43,175,257712
四川,2021,理科,42,174,257754
四川,2021,理科,40,173,257794
四川,2021,理科,35,172,257829
四川,2021,理科,49,171,257878
四川,2021,理科,27,170,257905
四川,2021,理科,28,169,257933
四川,2021,理科,40,168,257973
四川,2021,理科,42,167,258015
四川,2021,理科,34,166,258049
四川,2021,理科,32,165,258081
四川,2021,理科,25,164,258106
四川,2021,理科,29,163,258135
四川,2021,理科,30,162,258165
四川,2021,理科,21,161,258186
四川,2021,理科,22,160,258208
四川,2021,理科,24,159,258232
四川,2021,理科,16,158,258248
四川,2021,理科,28,157,258276
四川,2021,理科,17,156,258293
四川,2021,理科,28,155,258321
四川,2021,理科,25,154,258346
四川,2021,理科,19,153,258365
四川,2021,理科,28,152,258393
四川,2021,理科,19,151,258412
四川,2021,理科,16,150,258428
四川,2021,理科,16,149,258444
四川,2021,理科,14,148,258458
四川,2021,理科,10,147,258468
四川,2021,理科,14,146,258482
四川,2021,理科,21,145,258503
四川,2021,理科,11,144,258514
四川,2021,理科,12,143,258526
四川,2021,理科,11,142,258537
四川,2021,理科,11,141,258548
四川,2021,理科,12,140,258560
四川,2021,理科,8,139,258568
四川,2021,理科,10,138,258578
四川,2021,理科,9,137,258587
四川,2021,理科,9,136,258596
四川,2021,理科,6,135,258602
四川,2021,理科,8,134,258610
四川,2021,理科,5,133,258615
四川,2021,理科,7,132,258622
四川,2021,理科,9,131,258631
四川,2021,理科,8,130,258639
四川,2021,理科,14,129,258653
四川,2021,理科,9,128,258662
四川,2021,理科,6,127,258668
四川,2021,理科,6,126,258674
四川,2021,理科,4,125,258678
四川,2021,理科,2,124,258680
四川,2021,理科,5,123,258685
四川,2021,理科,6,122,258691
四川,2021,理科,9,121,258700
四川,2021,理科,4,120,258704
四川,2021,理科,6,119,258710
四川,2021,理科,4,118,258714
四川,2021,理科,5,117,258719
四川,2021,理科,6,116,258725
四川,2021,理科,3,115,258728
四川,2021,理科,6,114,258734
四川,2021,理科,1,113,258735
四川,2021,理科,1,112,258736
四川,2021,理科,3,111,258739
四川,2021,理科,2,110,258741
四川,2021,理科,9,109,258750
四川,2021,理科,2,108,258752
四川,2021,理科,1,107,258753
四川,2021,理科,4,106,258757
四川,2021,理科,2,105,258759
四川,2021,理科,2,104,258761
四川,2021,理科,1,103,258762
四川,2021,理科,1,102,258763
四川,2021,理科,3,101,258766
四川,2021,理科,4,100,258770
四川,2021,文科,29,643,29
四川,2021,文科,4,642,33
四川,2021,文科,8,641,41
四川,2021,文科,8,640,49
四川,2021,文科,7,639,56
四川,2021,文科,6,638,62
四川,2021,文科,10,637,72
四川,2021,文科,11,636,83
四川,2021,文科,11,635,94
四川,2021,文科,22,634,116
四川,2021,文科,17,633,133
四川,2021,文科,24,632,157
四川,2021,文科,17,631,174
四川,2021,文科,15,630,189
四川,2021,文科,25,629,214
四川,2021,文科,23,628,237
四川,2021,文科,29,627,266
四川,2021,文科,21,626,287
四川,2021,文科,38,625,325
四川,2021,文科,30,624,355
四川,2021,文科,42,623,397
四川,2021,文科,42,622,439
四川,2021,文科,40,621,479
四川,2021,文科,53,620,532
四川,2021,文科,43,619,575
四川,2021,文科,44,618,619
四川,2021,文科,58,617,677
四川,2021,文科,62,616,739
四川,2021,文科,51,615,790
四川,2021,文科,56,614,846
四川,2021,文科,62,613,908
四川,2021,文科,64,612,972
四川,2021,文科,61,611,1033
四川,2021,文科,76,610,1109
四川,2021,文科,80,609,1189
四川,2021,文科,77,608,1266
四川,2021,文科,93,607,1359
四川,2021,文科,82,606,1441
四川,2021,文科,83,605,1524
四川,2021,文科,83,604,1607
四川,2021,文科,113,603,1720
四川,2021,文科,93,602,1813
四川,2021,文科,103,601,1916
四川,2021,文科,97,600,2013
四川,2021,文科,112,599,2125
四川,2021,文科,100,598,2225
四川,2021,文科,125,597,2350
四川,2021,文科,128,596,2478
四川,2021,文科,129,595,2607
四川,2021,文科,126,594,2733
四川,2021,文科,142,593,2875
四川,2021,文科,137,592,3012
四川,2021,文科,144,591,3156
四川,2021,文科,144,590,3300
四川,2021,文科,148,589,3448
四川,2021,文科,138,588,3586
四川,2021,文科,146,587,3732
四川,2021,文科,157,586,3889
四川,2021,文科,173,585,4062
四川,2021,文科,177,584,4239
四川,2021,文科,177,583,4416
四川,2021,文科,186,582,4602
四川,2021,文科,175,581,4777
四川,2021,文科,204,580,4981
四川,2021,文科,181,579,5162
四川,2021,文科,229,578,5391
四川,2021,文科,243,577,5634
四川,2021,文科,239,576,5873
四川,2021,文科,214,575,6087
四川,2021,文科,222,574,6309
四川,2021,文科,282,573,6591
四川,2021,文科,256,572,6847
四川,2021,文科,273,571,7120
四川,2021,文科,257,570,7377
四川,2021,文科,266,569,7643
四川,2021,文科,288,568,7931
四川,2021,文科,290,567,8221
四川,2021,文科,251,566,8472
四川,2021,文科,278,565,8750
四川,2021,文科,277,564,9027
四川,2021,文科,304,563,9331
四川,2021,文科,330,562,9661
四川,2021,文科,333,561,9994
四川,2021,文科,349,560,10343
四川,2021,文科,347,559,10690
四川,2021,文科,379,558,11069
四川,2021,文科,332,557,11401
四川,2021,文科,383,556,11784
四川,2021,文科,402,555,12186
四川,2021,文科,353,554,12539
四川,2021,文科,382,553,12921
四川,2021,文科,407,552,13328
四川,2021,文科,428,551,13756
四川,2021,文科,395,550,14151
四川,2021,文科,431,549,14582
四川,2021,文科,463,548,15045
四川,2021,文科,415,547,15460
四川,2021,文科,440,546,15900
四川,2021,文科,453,545,16353
四川,2021,文科,458,544,16811
四川,2021,文科,494,543,17305
四川,2021,文科,498,542,17803
四川,2021,文科,475,541,18278
四川,2021,文科,526,540,18804
四川,2021,文科,518,539,19322
四川,2021,文科,496,538,19818
四川,2021,文科,563,537,20381
四川,2021,文科,498,536,20879
四川,2021,文科,519,535,21398
四川,2021,文科,545,534,21943
四川,2021,文科,558,533,22501
四川,2021,文科,576,532,23077
四川,2021,文科,595,531,23672
四川,2021,文科,570,530,24242
四川,2021,文科,591,529,24833
四川,2021,文科,576,528,25409
四川,2021,文科,605,527,26014
四川,2021,文科,614,526,26628
四川,2021,文科,645,525,27273
四川,2021,文科,665,524,27938
四川,2021,文科,633,523,28571
四川,2021,文科,696,522,29267
四川,2021,文科,666,521,29933
四川,2021,文科,707,520,30640
四川,2021,文科,685,519,31325
四川,2021,文科,697,518,32022
四川,2021,文科,708,517,32730
四川,2021,文科,711,516,33441
四川,2021,文科,737,515,34178
四川,2021,文科,766,514,34944
四川,2021,文科,762,513,35706
四川,2021,文科,745,512,36451
四川,2021,文科,755,511,37206
四川,2021,文科,791,510,37997
四川,2021,文科,737,509,38734
四川,2021,文科,758,508,39492
四川,2021,文科,777,507,40269
四川,2021,文科,826,506,41095
四川,2021,文科,740,505,41835
四川,2021,文科,769,504,42604
四川,2021,文科,788,503,43392
四川,2021,文科,818,502,44210
四川,2021,文科,837,501,45047
四川,2021,文科,869,500,45916
四川,2021,文科,825,499,46741
四川,2021,文科,773,498,47514
四川,2021,文科,833,497,48347
四川,2021,文科,852,496,49199
四川,2021,文科,880,495,50079
四川,2021,文科,836,494,50915
四川,2021,文科,825,493,51740
四川,2021,文科,825,492,52565
四川,2021,文科,845,491,53410
四川,2021,文科,756,490,54166
四川,2021,文科,813,489,54979
四川,2021,文科,806,488,55785
四川,2021,文科,876,487,56661
四川,2021,文科,838,486,57499
四川,2021,文科,847,485,58346
四川,2021,文科,841,484,59187
四川,2021,文科,901,483,60088
四川,2021,文科,881,482,60969
四川,2021,文科,836,481,61805
四川,2021,文科,780,480,62585
四川,2021,文科,814,479,63399
四川,2021,文科,801,478,64200
四川,2021,文科,835,477,65035
四川,2021,文科,804,476,65839
四川,2021,文科,869,475,66708
四川,2021,文科,845,474,67553
四川,2021,文科,844,473,68397
四川,2021,文科,868,472,69265
四川,2021,文科,812,471,70077
四川,2021,文科,834,470,70911
四川,2021,文科,820,469,71731
四川,2021,文科,827,468,72558
四川,2021,文科,887,467,73445
四川,2021,文科,810,466,74255
四川,2021,文科,811,465,75066
四川,2021,文科,747,464,75813
四川,2021,文科,792,463,76605
四川,2021,文科,815,462,77420
四川,2021,文科,778,461,78198
四川,2021,文科,806,460,79004
四川,2021,文科,810,459,79814
四川,2021,文科,808,458,80622
四川,2021,文科,779,457,81401
四川,2021,文科,741,456,82142
四川,2021,文科,754,455,82896
四川,2021,文科,736,454,83632
四川,2021,文科,730,453,84362
四川,2021,文科,764,452,85126
四川,2021,文科,732,451,85858
四川,2021,文科,769,450,86627
四川,2021,文科,719,449,87346
四川,2021,文科,776,448,88122
四川,2021,文科,726,447,88848
四川,2021,文科,738,446,89586
四川,2021,文科,725,445,90311
四川,2021,文科,716,444,91027
四川,2021,文科,734,443,91761
四川,2021,文科,751,442,92512
四川,2021,文科,731,441,93243
四川,2021,文科,722,440,93965
四川,2021,文科,725,439,94690
四川,2021,文科,672,438,95362
四川,2021,文科,681,437,96043
四川,2021,文科,741,436,96784
四川,2021,文科,723,435,97507
四川,2021,文科,686,434,98193
四川,2021,文科,697,433,98890
四川,2021,文科,656,432,99546
四川,2021,文科,743,431,100289
四川,2021,文科,733,430,101022
四川,2021,文科,652,429,101674
四川,2021,文科,708,428,102382
四川,2021,文科,649,427,103031
四川,2021,文科,637,426,103668
四川,2021,文科,705,425,104373
四川,2021,文科,620,424,104993
四川,2021,文科,692,423,105685
四川,2021,文科,677,422,106362
四川,2021,文科,619,421,106981
四川,2021,文科,637,420,107618
四川,2021,文科,659,419,108277
四川,2021,文科,679,418,108956
四川,2021,文科,695,417,109651
四川,2021,文科,652,416,110303
四川,2021,文科,700,415,111003
四川,2021,文科,714,414,111717
四川,2021,文科,635,413,112352
四川,2021,文科,672,412,113024
四川,2021,文科,621,411,113645
四川,2021,文科,642,410,114287
四川,2021,文科,631,409,114918
四川,2021,文科,661,408,115579
四川,2021,文科,673,407,116252
四川,2021,文科,613,406,116865
四川,2021,文科,656,405,117521
四川,2021,文科,617,404,118138
四川,2021,文科,624,403,118762
四川,2021,文科,670,402,119432
四川,2021,文科,612,401,120044
四川,2021,文科,673,400,120717
四川,2021,文科,668,399,121385
四川,2021,文科,661,398,122046
四川,2021,文科,589,397,122635
四川,2021,文科,664,396,123299
四川,2021,文科,616,395,123915
四川,2021,文科,627,394,124542
四川,2021,文科,630,393,125172
四川,2021,文科,640,392,125812
四川,2021,文科,657,391,126469
四川,2021,文科,673,390,127142
四川,2021,文科,652,389,127794
四川,2021,文科,633,388,128427
四川,2021,文科,618,387,129045
四川,2021,文科,650,386,129695
四川,2021,文科,646,385,130341
四川,2021,文科,625,384,130966
四川,2021,文科,673,383,131639
四川,2021,文科,602,382,132241
四川,2021,文科,643,381,132884
四川,2021,文科,686,380,133570
四川,2021,文科,615,379,134185
四川,2021,文科,675,378,134860
四川,2021,文科,657,377,135517
四川,2021,文科,613,376,136130
四川,2021,文科,629,375,136759
四川,2021,文科,628,374,137387
四川,2021,文科,642,373,138029
四川,2021,文科,633,372,138662
四川,2021,文科,626,371,139288
四川,2021,文科,617,370,139905
四川,2021,文科,591,369,140496
四川,2021,文科,639,368,141135
四川,2021,文科,620,367,141755
四川,2021,文科,581,366,142336
四川,2021,文科,605,365,142941
四川,2021,文科,601,364,143542
四川,2021,文科,586,363,144128
四川,2021,文科,595,362,144723
四川,2021,文科,592,361,145315
四川,2021,文科,614,360,145929
四川,2021,文科,556,359,146485
四川,2021,文科,640,358,147125
四川,2021,文科,587,357,147712
四川,2021,文科,569,356,148281
四川,2021,文科,562,355,148843
四川,2021,文科,563,354,149406
四川,2021,文科,572,353,149978
四川,2021,文科,576,352,150554
四川,2021,文科,578,351,151132
四川,2021,文科,549,350,151681
四川,2021,文科,589,349,152270
四川,2021,文科,580,348,152850
四川,2021,文科,577,347,153427
四川,2021,文科,550,346,153977
四川,2021,文科,526,345,154503
四川,2021,文科,577,344,155080
四川,2021,文科,561,343,155641
四川,2021,文科,596,342,156237
四川,2021,文科,522,341,156759
四川,2021,文科,554,340,157313
四川,2021,文科,521,339,157834
四川,2021,文科,519,338,158353
四川,2021,文科,536,337,158889
四川,2021,文科,510,336,159399
四川,2021,文科,518,335,159917
四川,2021,文科,541,334,160458
四川,2021,文科,525,333,160983
四川,2021,文科,528,332,161511
四川,2021,文科,473,331,161984
四川,2021,文科,519,330,162503
四川,2021,文科,465,329,162968
四川,2021,文科,503,328,163471
四川,2021,文科,500,327,163971
四川,2021,文科,526,326,164497
四川,2021,文科,455,325,164952
四川,2021,文科,435,324,165387
四川,2021,文科,460,323,165847
四川,2021,文科,487,322,166334
四川,2021,文科,451,321,166785
四川,2021,文科,452,320,167237
四川,2021,文科,474,319,167711
四川,2021,文科,468,318,168179
四川,2021,文科,441,317,168620
四川,2021,文科,426,316,169046
四川,2021,文科,428,315,169474
四川,2021,文科,467,314,169941
四川,2021,文科,437,313,170378
四川,2021,文科,421,312,170799
四川,2021,文科,442,311,171241
四川,2021,文科,438,310,171679
四川,2021,文科,439,309,172118
四川,2021,文科,409,308,172527
四川,2021,文科,363,307,172890
四川,2021,文科,411,306,173301
四川,2021,文科,424,305,173725
四川,2021,文科,369,304,174094
四川,2021,文科,393,303,174487
四川,2021,文科,409,302,174896
四川,2021,文科,405,301,175301
四川,2021,文科,427,300,175728
四川,2021,文科,394,299,176122
四川,2021,文科,400,298,176522
四川,2021,文科,382,297,176904
四川,2021,文科,388,296,177292
四川,2021,文科,354,295,177646
四川,2021,文科,372,294,178018
四川,2021,文科,349,293,178367
四川,2021,文科,386,292,178753
四川,2021,文科,365,291,179118
四川,2021,文科,384,290,179502
四川,2021,文科,339,289,179841
四川,2021,文科,355,288,180196
四川,2021,文科,327,287,180523
四川,2021,文科,315,286,180838
四川,2021,文科,359,285,181197
四川,2021,文科,300,284,181497
四川,2021,文科,309,283,181806
四川,2021,文科,324,282,182130
四川,2021,文科,301,281,182431
四川,2021,文科,316,280,182747
四川,2021,文科,335,279,183082
四川,2021,文科,311,278,183393
四川,2021,文科,316,277,183709
四川,2021,文科,325,276,184034
四川,2021,文科,329,275,184363
四川,2021,文科,281,274,184644
四川,2021,文科,295,273,184939
四川,2021,文科,263,272,185202
四川,2021,文科,284,271,185486
四川,2021,文科,237,270,185723
四川,2021,文科,260,269,185983
四川,2021,文科,246,268,186229
四川,2021,文科,296,267,186525
四川,2021,文科,280,266,186805
四川,2021,文科,269,265,187074
四川,2021,文科,270,264,187344
四川,2021,文科,217,263,187561
四川,2021,文科,236,262,187797
四川,2021,文科,246,261,188043
四川,2021,文科,253,260,188296
四川,2021,文科,250,259,188546
四川,2021,文科,252,258,188798
四川,2021,文科,222,257,189020
四川,2021,文科,226,256,189246
四川,2021,文科,207,255,189453
四川,2021,文科,221,254,189674
四川,2021,文科,231,253,189905
四川,2021,文科,239,252,190144
四川,2021,文科,225,251,190369
四川,2021,文科,215,250,190584
四川,2021,文科,194,249,190778
四川,2021,文科,205,248,190983
四川,2021,文科,193,247,191176
四川,2021,文科,199,246,191375
四川,2021,文科,176,245,191551
四川,2021,文科,187,244,191738
四川,2021,文科,191,243,191929
四川,2021,文科,198,242,192127
四川,2021,文科,191,241,192318
四川,2021,文科,189,240,192507
四川,2021,文科,203,239,192710
四川,2021,文科,210,238,192920
四川,2021,文科,184,237,193104
四川,2021,文科,172,236,193276
四川,2021,文科,163,235,193439
四川,2021,文科,154,234,193593
四川,2021,文科,170,233,193763
四川,2021,文科,147,232,193910
四川,2021,文科,169,231,194079
四川,2021,文科,165,230,194244
四川,2021,文科,152,229,194396
四川,2021,文科,156,228,194552
四川,2021,文科,148,227,194700
四川,2021,文科,136,226,194836
四川,2021,文科,141,225,194977
四川,2021,文科,149,224,195126
四川,2021,文科,146,223,195272
四川,2021,文科,131,222,195403
四川,2021,文科,127,221,195530
四川,2021,文科,147,220,195677
四川,2021,文科,120,219,195797
四川,2021,文科,127,218,195924
四川,2021,文科,140,217,196064
四川,2021,文科,99,216,196163
四川,2021,文科,126,215,196289
四川,2021,文科,111,214,196400
四川,2021,文科,106,213,196506
四川,2021,文科,116,212,196622
四川,2021,文科,108,211,196730
四川,2021,文科,109,210,196839
四川,2021,文科,94,209,196933
四川,2021,文科,100,208,197033
四川,2021,文科,100,207,197133
四川,2021,文科,97,206,197230
四川,2021,文科,87,205,197317
四川,2021,文科,71,204,197388
四川,2021,文科,84,203,197472
四川,2021,文科,73,202,197545
四川,2021,文科,92,201,197637
四川,2021,文科,80,200,197717
四川,2021,文科,97,199,197814
四川,2021,文科,74,198,197888
四川,2021,文科,84,197,197972
四川,2021,文科,60,196,198032
四川,2021,文科,66,195,198098
四川,2021,文科,76,194,198174
四川,2021,文科,70,193,198244
四川,2021,文科,64,192,198308
四川,2021,文科,52,191,198360
四川,2021,文科,64,190,198424
四川,2021,文科,58,189,198482
四川,2021,文科,46,188,198528
四川,2021,文科,53,187,198581
四川,2021,文科,62,186,198643
四川,2021,文科,54,185,198697
四川,2021,文科,43,184,198740
四川,2021,文科,54,183,198794
四川,2021,文科,62,182,198856
四川,2021,文科,52,181,198908
四川,2021,文科,48,180,198956
四川,2021,文科,44,179,199000
四川,2021,文科,51,178,199051
四川,2021,文科,38,177,199089
四川,2021,文科,43,176,199132
四川,2021,文科,58,175,199190
四川,2021,文科,45,174,199235
四川,2021,文科,42,173,199277
四川,2021,文科,30,172,199307
四川,2021,文科,39,171,199346
四川,2021,文科,29,170,199375
四川,2021,文科,28,169,199403
四川,2021,文科,35,168,199438
四川,2021,文科,27,167,199465
四川,2021,文科,41,166,199506
四川,2021,文科,23,165,199529
四川,2021,文科,21,164,199550
四川,2021,文科,24,163,199574
四川,2021,文科,35,162,199609
四川,2021,文科,27,161,199636
四川,2021,文科,24,160,199660
四川,2021,文科,34,159,199694
四川,2021,文科,25,158,199719
四川,2021,文科,23,157,199742
四川,2021,文科,22,156,199764
四川,2021,文科,15,155,199779
四川,2021,文科,14,154,199793
四川,2021,文科,21,153,199814
四川,2021,文科,19,152,199833
四川,2021,文科,18,151,199851
四川,2021,文科,15,150,199866
四川,2021,文科,22,149,199888
四川,2021,文科,19,148,199907
四川,2021,文科,11,147,199918
四川,2021,文科,13,146,199931
四川,2021,文科,20,145,199951
四川,2021,文科,15,144,199966
四川,2021,文科,15,143,199981
四川,2021,文科,17,142,199998
四川,2021,文科,14,141,200012
四川,2021,文科,17,140,200029
四川,2021,文科,12,139,200041
四川,2021,文科,11,138,200052
四川,2021,文科,13,137,200065
四川,2021,文科,13,136,200078
四川,2021,文科,7,135,200085
四川,2021,文科,8,134,200093
四川,2021,文科,6,133,200099
四川,2021,文科,7,132,200106
四川,2021,文科,19,131,200125
四川,2021,文科,4,130,200129
四川,2021,文科,6,129,200135
四川,2021,文科,7,128,200142
四川,2021,文科,3,127,200145
四川,2021,文科,10,126,200155
四川,2021,文科,7,125,200162
四川,2021,文科,9,124,200171
四川,2021,文科,5,123,200176
四川,2021,文科,11,122,200187
四川,2021,文科,5,121,200192
四川,2021,文科,7,120,200199
四川,2021,文科,7,119,200206
四川,2021,文科,6,118,200212
四川,2021,文科,5,117,200217
四川,2021,文科,9,116,200226
四川,2021,文科,5,115,200231
四川,2021,文科,6,114,200237
四川,2021,文科,5,113,200242
四川,2021,文科,6,112,200248
四川,2021,文科,5,111,200253
四川,2021,文科,7,110,200260
四川,2021,文科,5,109,200265
四川,2021,文科,8,108,200273
四川,2021,文科,10,107,200283
四川,2021,文科,5,106,200288
四川,2021,文科,6,105,200294
四川,2021,文科,5,104,200299
四川,2021,文科,5,103,200304
四川,2021,文科,1,102,200305
四川,2021,文科,1,101,200306
四川,2021,文科,2,100,200308
云南,2021,理科,55,693,55
云南,2021,理科,4,692,59
云南,2021,理科,4,691,63
云南,2021,理科,1,690,64
云南,2021,理科,4,689,68
云南,2021,理科,2,688,70
云南,2021,理科,6,687,76
云南,2021,理科,9,686,85
云南,2021,理科,11,685,96
云南,2021,理科,9,684,105
云南,2021,理科,7,683,112
云南,2021,理科,14,682,126
云南,2021,理科,12,681,138
云南,2021,理科,12,680,150
云南,2021,理科,13,679,163
云南,2021,理科,17,678,180
云南,2021,理科,17,677,197
云南,2021,理科,21,676,218
云南,2021,理科,12,675,230
云南,2021,理科,16,674,246
云南,2021,理科,17,673,263
云南,2021,理科,13,672,276
云南,2021,理科,13,671,289
云南,2021,理科,19,670,308
云南,2021,理科,21,669,329
云南,2021,理科,16,668,345
云南,2021,理科,24,667,369
云南,2021,理科,21,666,390
云南,2021,理科,26,665,416
云南,2021,理科,29,664,445
云南,2021,理科,34,663,479
云南,2021,理科,31,662,510
云南,2021,理科,34,661,544
云南,2021,理科,24,660,568
云南,2021,理科,35,659,603
云南,2021,理科,36,658,639
云南,2021,理科,46,657,685
云南,2021,理科,42,656,727
云南,2021,理科,44,655,771
云南,2021,理科,40,654,811
云南,2021,理科,37,653,848
云南,2021,理科,52,652,900
云南,2021,理科,48,651,948
云南,2021,理科,52,650,1000
云南,2021,理科,35,649,1035
云南,2021,理科,56,648,1091
云南,2021,理科,53,647,1144
云南,2021,理科,78,646,1222
云南,2021,理科,76,645,1298
云南,2021,理科,70,644,1368
云南,2021,理科,70,643,1438
云南,2021,理科,57,642,1495
云南,2021,理科,69,641,1564
云南,2021,理科,90,640,1654
云南,2021,理科,78,639,1732
云南,2021,理科,92,638,1824
云南,2021,理科,76,637,1900
云南,2021,理科,77,636,1977
云南,2021,理科,84,635,2061
云南,2021,理科,97,634,2158
云南,2021,理科,96,633,2254
云南,2021,理科,92,632,2346
云南,2021,理科,112,631,2458
云南,2021,理科,106,630,2564
云南,2021,理科,101,629,2665
云南,2021,理科,117,628,2782
云南,2021,理科,123,627,2905
云南,2021,理科,126,626,3031
云南,2021,理科,135,625,3166
云南,2021,理科,116,624,3282
云南,2021,理科,148,623,3430
云南,2021,理科,144,622,3574
云南,2021,理科,131,621,3705
云南,2021,理科,143,620,3848
云南,2021,理科,146,619,3994
云南,2021,理科,176,618,4170
云南,2021,理科,135,617,4305
云南,2021,理科,153,616,4458
云南,2021,理科,170,615,4628
云南,2021,理科,162,614,4790
云南,2021,理科,165,613,4955
云南,2021,理科,171,612,5126
云南,2021,理科,176,611,5302
云南,2021,理科,156,610,5458
云南,2021,理科,183,609,5641
云南,2021,理科,178,608,5819
云南,2021,理科,182,607,6001
云南,2021,理科,194,606,6195
云南,2021,理科,227,605,6422
云南,2021,理科,199,604,6621
云南,2021,理科,221,603,6842
云南,2021,理科,200,602,7042
云南,2021,理科,208,601,7250
云南,2021,理科,215,600,7465
云南,2021,理科,205,599,7670
云南,2021,理科,234,598,7904
云南,2021,理科,244,597,8148
云南,2021,理科,210,596,8358
云南,2021,理科,216,595,8574
云南,2021,理科,219,594,8793
云南,2021,理科,244,593,9037
云南,2021,理科,277,592,9314
云南,2021,理科,250,591,9564
云南,2021,理科,260,590,9824
云南,2021,理科,277,589,10101
云南,2021,理科,267,588,10368
云南,2021,理科,270,587,10638
云南,2021,理科,279,586,10917
云南,2021,理科,279,585,11196
云南,2021,理科,268,584,11464
云南,2021,理科,283,583,11747
云南,2021,理科,322,582,12069
云南,2021,理科,296,581,12365
云南,2021,理科,308,580,12673
云南,2021,理科,343,579,13016
云南,2021,理科,297,578,13313
云南,2021,理科,324,577,13637
云南,2021,理科,347,576,13984
云南,2021,理科,331,575,14315
云南,2021,理科,333,574,14648
云南,2021,理科,360,573,15008
云南,2021,理科,343,572,15351
云南,2021,理科,296,571,15647
云南,2021,理科,358,570,16005
云南,2021,理科,337,569,16342
云南,2021,理科,368,568,16710
云南,2021,理科,327,567,17037
云南,2021,理科,382,566,17419
云南,2021,理科,358,565,17777
云南,2021,理科,388,564,18165
云南,2021,理科,322,563,18487
云南,2021,理科,403,562,18890
云南,2021,理科,432,561,19322
云南,2021,理科,392,560,19714
云南,2021,理科,404,559,20118
云南,2021,理科,377,558,20495
云南,2021,理科,384,557,20879
云南,2021,理科,380,556,21259
云南,2021,理科,383,555,21642
云南,2021,理科,457,554,22099
云南,2021,理科,413,553,22512
云南,2021,理科,423,552,22935
云南,2021,理科,471,551,23406
云南,2021,理科,454,550,23860
云南,2021,理科,438,549,24298
云南,2021,理科,419,548,24717
云南,2021,理科,426,547,25143
云南,2021,理科,454,546,25597
云南,2021,理科,417,545,26014
云南,2021,理科,426,544,26440
云南,2021,理科,423,543,26863
云南,2021,理科,492,542,27355
云南,2021,理科,478,541,27833
云南,2021,理科,437,540,28270
云南,2021,理科,484,539,28754
云南,2021,理科,445,538,29199
云南,2021,理科,451,537,29650
云南,2021,理科,474,536,30124
云南,2021,理科,477,535,30601
云南,2021,理科,480,534,31081
云南,2021,理科,505,533,31586
云南,2021,理科,482,532,32068
云南,2021,理科,465,531,32533
云南,2021,理科,492,530,33025
云南,2021,理科,513,529,33538
云南,2021,理科,513,528,34051
云南,2021,理科,514,527,34565
云南,2021,理科,514,526,35079
云南,2021,理科,546,525,35625
云南,2021,理科,531,524,36156
云南,2021,理科,545,523,36701
云南,2021,理科,546,522,37247
云南,2021,理科,534,521,37781
云南,2021,理科,535,520,38316
云南,2021,理科,576,519,38892
云南,2021,理科,487,518,39379
云南,2021,理科,530,517,39909
云南,2021,理科,578,516,40487
云南,2021,理科,558,515,41045
云南,2021,理科,563,514,41608
云南,2021,理科,560,513,42168
云南,2021,理科,568,512,42736
云南,2021,理科,596,511,43332
云南,2021,理科,502,510,43834
云南,2021,理科,581,509,44415
云南,2021,理科,588,508,45003
云南,2021,理科,569,507,45572
云南,2021,理科,595,506,46167
云南,2021,理科,591,505,46758
云南,2021,理科,602,504,47360
云南,2021,理科,585,503,47945
云南,2021,理科,603,502,48548
云南,2021,理科,619,501,49167
云南,2021,理科,627,500,49794
云南,2021,理科,608,499,50402
云南,2021,理科,607,498,51009
云南,2021,理科,603,497,51612
云南,2021,理科,569,496,52181
云南,2021,理科,598,495,52779
云南,2021,理科,595,494,53374
云南,2021,理科,599,493,53973
云南,2021,理科,630,492,54603
云南,2021,理科,627,491,55230
云南,2021,理科,650,490,55880
云南,2021,理科,647,489,56527
云南,2021,理科,639,488,57166
云南,2021,理科,640,487,57806
云南,2021,理科,658,486,58464
云南,2021,理科,626,485,59090
云南,2021,理科,655,484,59745
云南,2021,理科,664,483,60409
云南,2021,理科,622,482,61031
云南,2021,理科,704,481,61735
云南,2021,理科,667,480,62402
云南,2021,理科,589,479,62991
云南,2021,理科,632,478,63623
云南,2021,理科,676,477,64299
云南,2021,理科,703,476,65002
云南,2021,理科,662,475,65664
云南,2021,理科,638,474,66302
云南,2021,理科,653,473,66955
云南,2021,理科,646,472,67601
云南,2021,理科,684,471,68285
云南,2021,理科,638,470,68923
云南,2021,理科,656,469,69579
云南,2021,理科,698,468,70277
云南,2021,理科,683,467,70960
云南,2021,理科,678,466,71638
云南,2021,理科,690,465,72328
云南,2021,理科,667,464,72995
云南,2021,理科,724,463,73719
云南,2021,理科,685,462,74404
云南,2021,理科,714,461,75118
云南,2021,理科,710,460,75828
云南,2021,理科,658,459,76486
云南,2021,理科,651,458,77137
云南,2021,理科,698,457,77835
云南,2021,理科,668,456,78503
云南,2021,理科,654,455,79157
云南,2021,理科,643,454,79800
云南,2021,理科,681,453,80481
云南,2021,理科,704,452,81185
云南,2021,理科,709,451,81894
云南,2021,理科,714,450,82608
云南,2021,理科,733,449,83341
云南,2021,理科,720,448,84061
云南,2021,理科,658,447,84719
云南,2021,理科,720,446,85439
云南,2021,理科,721,445,86160
云南,2021,理科,664,444,86824
云南,2021,理科,693,443,87517
云南,2021,理科,664,442,88181
云南,2021,理科,682,441,88863
云南,2021,理科,654,440,89517
云南,2021,理科,712,439,90229
云南,2021,理科,685,438,90914
云南,2021,理科,741,437,91655
云南,2021,理科,686,436,92341
云南,2021,理科,725,435,93066
云南,2021,理科,670,434,93736
云南,2021,理科,754,433,94490
云南,2021,理科,672,432,95162
云南,2021,理科,616,431,95778
云南,2021,理科,663,430,96441
云南,2021,理科,660,429,97101
云南,2021,理科,640,428,97741
云南,2021,理科,644,427,98385
云南,2021,理科,666,426,99051
云南,2021,理科,651,425,99702
云南,2021,理科,692,424,100394
云南,2021,理科,661,423,101055
云南,2021,理科,641,422,101696
云南,2021,理科,662,421,102358
云南,2021,理科,626,420,102984
云南,2021,理科,687,419,103671
云南,2021,理科,666,418,104337
云南,2021,理科,657,417,104994
云南,2021,理科,673,416,105667
云南,2021,理科,661,415,106328
云南,2021,理科,636,414,106964
云南,2021,理科,611,413,107575
云南,2021,理科,634,412,108209
云南,2021,理科,624,411,108833
云南,2021,理科,615,410,109448
云南,2021,理科,589,409,110037
云南,2021,理科,637,408,110674
云南,2021,理科,630,407,111304
云南,2021,理科,625,406,111929
云南,2021,理科,576,405,112505
云南,2021,理科,611,404,113116
云南,2021,理科,636,403,113752
云南,2021,理科,643,402,114395
云南,2021,理科,609,401,115004
云南,2021,理科,639,400,115643
云南,2021,理科,637,399,116280
云南,2021,理科,584,398,116864
云南,2021,理科,559,397,117423
云南,2021,理科,585,396,118008
云南,2021,理科,591,395,118599
云南,2021,理科,598,394,119197
云南,2021,理科,594,393,119791
云南,2021,理科,589,392,120380
云南,2021,理科,556,391,120936
云南,2021,理科,589,390,121525
云南,2021,理科,584,389,122109
云南,2021,理科,572,388,122681
云南,2021,理科,540,387,123221
云南,2021,理科,537,386,123758
云南,2021,理科,540,385,124298
云南,2021,理科,570,384,124868
云南,2021,理科,565,383,125433
云南,2021,理科,489,382,125922
云南,2021,理科,556,381,126478
云南,2021,理科,523,380,127001
云南,2021,理科,523,379,127524
云南,2021,理科,479,378,128003
云南,2021,理科,534,377,128537
云南,2021,理科,523,376,129060
云南,2021,理科,522,375,129582
云南,2021,理科,517,374,130099
云南,2021,理科,496,373,130595
云南,2021,理科,488,372,131083
云南,2021,理科,500,371,131583
云南,2021,理科,505,370,132088
云南,2021,理科,460,369,132548
云南,2021,理科,441,368,132989
云南,2021,理科,486,367,133475
云南,2021,理科,451,366,133926
云南,2021,理科,473,365,134399
云南,2021,理科,470,364,134869
云南,2021,理科,447,363,135316
云南,2021,理科,426,362,135742
云南,2021,理科,419,361,136161
云南,2021,理科,458,360,136619
云南,2021,理科,441,359,137060
云南,2021,理科,465,358,137525
云南,2021,理科,421,357,137946
云南,2021,理科,440,356,138386
云南,2021,理科,463,355,138849
云南,2021,理科,441,354,139290
云南,2021,理科,432,353,139722
云南,2021,理科,436,352,140158
云南,2021,理科,426,351,140584
云南,2021,理科,374,350,140958
云南,2021,理科,434,349,141392
云南,2021,理科,434,348,141826
云南,2021,理科,376,347,142202
云南,2021,理科,435,346,142637
云南,2021,理科,385,345,143022
云南,2021,理科,365,344,143387
云南,2021,理科,397,343,143784
云南,2021,理科,376,342,144160
云南,2021,理科,361,341,144521
云南,2021,理科,368,340,144889
云南,2021,理科,349,339,145238
云南,2021,理科,348,338,145586
云南,2021,理科,349,337,145935
云南,2021,理科,360,336,146295
云南,2021,理科,357,335,146652
云南,2021,理科,332,334,146984
云南,2021,理科,341,333,147325
云南,2021,理科,305,332,147630
云南,2021,理科,366,331,147996
云南,2021,理科,332,330,148328
云南,2021,理科,338,329,148666
云南,2021,理科,309,328,148975
云南,2021,理科,323,327,149298
云南,2021,理科,298,326,149596
云南,2021,理科,318,325,149914
云南,2021,理科,276,324,150190
云南,2021,理科,288,323,150478
云南,2021,理科,316,322,150794
云南,2021,理科,269,321,151063
云南,2021,理科,296,320,151359
云南,2021,理科,281,319,151640
云南,2021,理科,273,318,151913
云南,2021,理科,247,317,152160
云南,2021,理科,266,316,152426
云南,2021,理科,245,315,152671
云南,2021,理科,239,314,152910
云南,2021,理科,251,313,153161
云南,2021,理科,275,312,153436
云南,2021,理科,239,311,153675
云南,2021,理科,254,310,153929
云南,2021,理科,223,309,154152
云南,2021,理科,219,308,154371
云南,2021,理科,234,307,154605
云南,2021,理科,207,306,154812
云南,2021,理科,222,305,155034
云南,2021,理科,207,304,155241
云南,2021,理科,234,303,155475
云南,2021,理科,232,302,155707
云南,2021,理科,208,301,155915
云南,2021,理科,198,300,156113
云南,2021,理科,198,299,156311
云南,2021,理科,192,298,156503
云南,2021,理科,207,297,156710
云南,2021,理科,205,296,156915
云南,2021,理科,202,295,157117
云南,2021,理科,180,294,157297
云南,2021,理科,171,293,157468
云南,2021,理科,169,292,157637
云南,2021,理科,168,291,157805
云南,2021,理科,154,290,157959
云南,2021,理科,158,289,158117
云南,2021,理科,182,288,158299
云南,2021,理科,177,287,158476
云南,2021,理科,161,286,158637
云南,2021,理科,142,285,158779
云南,2021,理科,152,284,158931
云南,2021,理科,173,283,159104
云南,2021,理科,137,282,159241
云南,2021,理科,158,281,159399
云南,2021,理科,121,280,159520
云南,2021,理科,138,279,159658
云南,2021,理科,146,278,159804
云南,2021,理科,122,277,159926
云南,2021,理科,143,276,160069
云南,2021,理科,127,275,160196
云南,2021,理科,112,274,160308
云南,2021,理科,114,273,160422
云南,2021,理科,106,272,160528
云南,2021,理科,133,271,160661
云南,2021,理科,109,270,160770
云南,2021,理科,106,269,160876
云南,2021,理科,95,268,160971
云南,2021,理科,102,267,161073
云南,2021,理科,92,266,161165
云南,2021,理科,88,265,161253
云南,2021,理科,116,264,161369
云南,2021,理科,108,263,161477
云南,2021,理科,67,262,161544
云南,2021,理科,102,261,161646
云南,2021,理科,103,260,161749
云南,2021,理科,82,259,161831
云南,2021,理科,77,258,161908
云南,2021,理科,67,257,161975
云南,2021,理科,96,256,162071
云南,2021,理科,91,255,162162
云南,2021,理科,85,254,162247
云南,2021,理科,74,253,162321
云南,2021,理科,73,252,162394
云南,2021,理科,57,251,162451
云南,2021,理科,75,250,162526
云南,2021,理科,75,249,162601
云南,2021,理科,67,248,162668
云南,2021,理科,73,247,162741
云南,2021,理科,54,246,162795
云南,2021,理科,57,245,162852
云南,2021,理科,58,244,162910
云南,2021,理科,46,243,162956
云南,2021,理科,55,242,163011
云南,2021,理科,58,241,163069
云南,2021,理科,58,240,163127
云南,2021,理科,50,239,163177
云南,2021,理科,49,238,163226
云南,2021,理科,69,237,163295
云南,2021,理科,45,236,163340
云南,2021,理科,40,235,163380
云南,2021,理科,47,234,163427
云南,2021,理科,34,233,163461
云南,2021,理科,29,232,163490
云南,2021,理科,48,231,163538
云南,2021,理科,43,230,163581
云南,2021,理科,29,229,163610
云南,2021,理科,32,228,163642
云南,2021,理科,39,227,163681
云南,2021,理科,38,226,163719
云南,2021,理科,29,225,163748
云南,2021,理科,38,224,163786
云南,2021,理科,22,223,163808
云南,2021,理科,21,222,163829
云南,2021,理科,26,221,163855
云南,2021,理科,22,220,163877
云南,2021,理科,25,219,163902
云南,2021,理科,22,218,163924
云南,2021,理科,19,217,163943
云南,2021,理科,24,216,163967
云南,2021,理科,17,215,163984
云南,2021,理科,19,214,164003
云南,2021,理科,26,213,164029
云南,2021,理科,24,212,164053
云南,2021,理科,20,211,164073
云南,2021,理科,16,210,164089
云南,2021,理科,13,209,164102
云南,2021,理科,18,208,164120
云南,2021,理科,17,207,164137
云南,2021,理科,13,206,164150
云南,2021,理科,8,205,164158
云南,2021,理科,17,204,164175
云南,2021,理科,18,203,164193
云南,2021,理科,17,202,164210
云南,2021,理科,9,201,164219
云南,2021,理科,13,200,164232
云南,2021,理科,98,190,164330
云南,2021,理科,49,180,164379
云南,2021,理科,39,170,164418
云南,2021,理科,24,160,164442
云南,2021,理科,16,150,164458
云南,2021,理科,9,140,164467
云南,2021,理科,11,130,164478
云南,2021,理科,5,120,164483
云南,2021,理科,8,110,164491
云南,2021,理科,3,100,164494
云南,2021,文科,54,675,54
云南,2021,文科,6,674,60
云南,2021,文科,3,673,63
云南,2021,文科,5,672,68
云南,2021,文科,4,671,72
云南,2021,文科,3,670,75
云南,2021,文科,7,669,82
云南,2021,文科,5,668,87
云南,2021,文科,14,667,101
云南,2021,文科,11,666,112
云南,2021,文科,7,665,119
云南,2021,文科,14,664,133
云南,2021,文科,4,663,137
云南,2021,文科,14,662,151
云南,2021,文科,17,661,168
云南,2021,文科,17,660,185
云南,2021,文科,13,659,198
云南,2021,文科,15,658,213
云南,2021,文科,22,657,235
云南,2021,文科,22,656,257
云南,2021,文科,20,655,277
云南,2021,文科,19,654,296
云南,2021,文科,22,653,318
云南,2021,文科,20,652,338
云南,2021,文科,20,651,358
云南,2021,文科,25,650,383
云南,2021,文科,18,649,401
云南,2021,文科,29,648,430
云南,2021,文科,24,647,454
云南,2021,文科,29,646,483
云南,2021,文科,35,645,518
云南,2021,文科,33,644,551
云南,2021,文科,34,643,585
云南,2021,文科,32,642,617
云南,2021,文科,38,641,655
云南,2021,文科,33,640,688
云南,2021,文科,36,639,724
云南,2021,文科,56,638,780
云南,2021,文科,45,637,825
云南,2021,文科,45,636,870
云南,2021,文科,41,635,911
云南,2021,文科,53,634,964
云南,2021,文科,40,633,1004
云南,2021,文科,57,632,1061
云南,2021,文科,55,631,1116
云南,2021,文科,66,630,1182
云南,2021,文科,68,629,1250
云南,2021,文科,43,628,1293
云南,2021,文科,68,627,1361
云南,2021,文科,58,626,1419
云南,2021,文科,73,625,1492
云南,2021,文科,85,624,1577
云南,2021,文科,66,623,1643
云南,2021,文科,93,622,1736
云南,2021,文科,79,621,1815
云南,2021,文科,75,620,1890
云南,2021,文科,85,619,1975
云南,2021,文科,99,618,2074
云南,2021,文科,102,617,2176
云南,2021,文科,112,616,2288
云南,2021,文科,83,615,2371
云南,2021,文科,83,614,2454
云南,2021,文科,103,613,2557
云南,2021,文科,107,612,2664
云南,2021,文科,107,611,2771
云南,2021,文科,108,610,2879
云南,2021,文科,116,609,2995
云南,2021,文科,119,608,3114
云南,2021,文科,110,607,3224
云南,2021,文科,116,606,3340
云南,2021,文科,121,605,3461
云南,2021,文科,152,604,3613
云南,2021,文科,133,603,3746
云南,2021,文科,144,602,3890
云南,2021,文科,134,601,4024
云南,2021,文科,132,600,4156
云南,2021,文科,140,599,4296
云南,2021,文科,138,598,4434
云南,2021,文科,161,597,4595
云南,2021,文科,178,596,4773
云南,2021,文科,146,595,4919
云南,2021,文科,167,594,5086
云南,2021,文科,178,593,5264
云南,2021,文科,194,592,5458
云南,2021,文科,175,591,5633
云南,2021,文科,204,590,5837
云南,2021,文科,209,589,6046
云南,2021,文科,180,588,6226
云南,2021,文科,222,587,6448
云南,2021,文科,200,586,6648
云南,2021,文科,213,585,6861
云南,2021,文科,222,584,7083
云南,2021,文科,217,583,7300
云南,2021,文科,201,582,7501
云南,2021,文科,214,581,7715
云南,2021,文科,243,580,7958
云南,2021,文科,256,579,8214
云南,2021,文科,246,578,8460
云南,2021,文科,254,577,8714
云南,2021,文科,252,576,8966
云南,2021,文科,232,575,9198
云南,2021,文科,271,574,9469
云南,2021,文科,251,573,9720
云南,2021,文科,278,572,9998
云南,2021,文科,282,571,10280
云南,2021,文科,234,570,10514
云南,2021,文科,252,569,10766
云南,2021,文科,276,568,11042
云南,2021,文科,286,567,11328
云南,2021,文科,290,566,11618
云南,2021,文科,319,565,11937
云南,2021,文科,287,564,12224
云南,2021,文科,316,563,12540
云南,2021,文科,335,562,12875
云南,2021,文科,312,561,13187
云南,2021,文科,323,560,13510
云南,2021,文科,312,559,13822
云南,2021,文科,346,558,14168
云南,2021,文科,306,557,14474
云南,2021,文科,366,556,14840
云南,2021,文科,330,555,15170
云南,2021,文科,357,554,15527
云南,2021,文科,356,553,15883
云南,2021,文科,373,552,16256
云南,2021,文科,385,551,16641
云南,2021,文科,383,550,17024
云南,2021,文科,382,549,17406
云南,2021,文科,369,548,17775
云南,2021,文科,390,547,18165
云南,2021,文科,380,546,18545
云南,2021,文科,375,545,18920
云南,2021,文科,397,544,19317
云南,2021,文科,408,543,19725
云南,2021,文科,436,542,20161
云南,2021,文科,361,541,20522
云南,2021,文科,406,540,20928
云南,2021,文科,402,539,21330
云南,2021,文科,432,538,21762
云南,2021,文科,467,537,22229
云南,2021,文科,446,536,22675
云南,2021,文科,463,535,23138
云南,2021,文科,434,534,23572
云南,2021,文科,454,533,24026
云南,2021,文科,476,532,24502
云南,2021,文科,463,531,24965
云南,2021,文科,418,530,25383
云南,2021,文科,462,529,25845
云南,2021,文科,495,528,26340
云南,2021,文科,492,527,26832
云南,2021,文科,527,526,27359
云南,2021,文科,479,525,27838
云南,2021,文科,514,524,28352
云南,2021,文科,544,523,28896
云南,2021,文科,491,522,29387
云南,2021,文科,484,521,29871
云南,2021,文科,504,520,30375
云南,2021,文科,508,519,30883
云南,2021,文科,530,518,31413
云南,2021,文科,493,517,31906
云南,2021,文科,541,516,32447
云南,2021,文科,518,515,32965
云南,2021,文科,514,514,33479
云南,2021,文科,534,513,34013
云南,2021,文科,541,512,34554
云南,2021,文科,582,511,35136
云南,2021,文科,524,510,35660
云南,2021,文科,507,509,36167
云南,2021,文科,587,508,36754
云南,2021,文科,538,507,37292
云南,2021,文科,564,506,37856
云南,2021,文科,543,505,38399
云南,2021,文科,569,504,38968
云南,2021,文科,537,503,39505
云南,2021,文科,579,502,40084
云南,2021,文科,551,501,40635
云南,2021,文科,535,500,41170
云南,2021,文科,603,499,41773
云南,2021,文科,570,498,42343
云南,2021,文科,532,497,42875
云南,2021,文科,594,496,43469
云南,2021,文科,543,495,44012
云南,2021,文科,628,494,44640
云南,2021,文科,591,493,45231
云南,2021,文科,598,492,45829
云南,2021,文科,558,491,46387
云南,2021,文科,583,490,46970
云南,2021,文科,583,489,47553
云南,2021,文科,588,488,48141
云南,2021,文科,580,487,48721
云南,2021,文科,518,486,49239
云南,2021,文科,608,485,49847
云南,2021,文科,581,484,50428
云南,2021,文科,604,483,51032
云南,2021,文科,630,482,51662
云南,2021,文科,574,481,52236
云南,2021,文科,582,480,52818
云南,2021,文科,622,479,53440
云南,2021,文科,603,478,54043
云南,2021,文科,614,477,54657
云南,2021,文科,607,476,55264
云南,2021,文科,597,475,55861
云南,2021,文科,579,474,56440
云南,2021,文科,593,473,57033
云南,2021,文科,613,472,57646
云南,2021,文科,575,471,58221
云南,2021,文科,606,470,58827
云南,2021,文科,599,469,59426
云南,2021,文科,572,468,59998
云南,2021,文科,618,467,60616
云南,2021,文科,616,466,61232
云南,2021,文科,594,465,61826
云南,2021,文科,602,464,62428
云南,2021,文科,584,463,63012
云南,2021,文科,597,462,63609
云南,2021,文科,616,461,64225
云南,2021,文科,657,460,64882
云南,2021,文科,582,459,65464
云南,2021,文科,598,458,66062
云南,2021,文科,561,457,66623
云南,2021,文科,648,456,67271
云南,2021,文科,577,455,67848
云南,2021,文科,624,454,68472
云南,2021,文科,624,453,69096
云南,2021,文科,641,452,69737
云南,2021,文科,605,451,70342
云南,2021,文科,558,450,70900
云南,2021,文科,586,449,71486
云南,2021,文科,611,448,72097
云南,2021,文科,597,447,72694
云南,2021,文科,600,446,73294
云南,2021,文科,636,445,73930
云南,2021,文科,586,444,74516
云南,2021,文科,548,443,75064
云南,2021,文科,595,442,75659
云南,2021,文科,618,441,76277
云南,2021,文科,581,440,76858
云南,2021,文科,587,439,77445
云南,2021,文科,614,438,78059
云南,2021,文科,610,437,78669
云南,2021,文科,616,436,79285
云南,2021,文科,600,435,79885
云南,2021,文科,580,434,80465
云南,2021,文科,614,433,81079
云南,2021,文科,587,432,81666
云南,2021,文科,578,431,82244
云南,2021,文科,578,430,82822
云南,2021,文科,608,429,83430
云南,2021,文科,604,428,84034
云南,2021,文科,618,427,84652
云南,2021,文科,578,426,85230
云南,2021,文科,598,425,85828
云南,2021,文科,596,424,86424
云南,2021,文科,569,423,86993
云南,2021,文科,586,422,87579
云南,2021,文科,574,421,88153
云南,2021,文科,517,420,88670
云南,2021,文科,558,419,89228
云南,2021,文科,545,418,89773
云南,2021,文科,555,417,90328
云南,2021,文科,584,416,90912
云南,2021,文科,504,415,91416
云南,2021,文科,561,414,91977
云南,2021,文科,556,413,92533
云南,2021,文科,562,412,93095
云南,2021,文科,519,411,93614
云南,2021,文科,524,410,94138
云南,2021,文科,517,409,94655
云南,2021,文科,514,408,95169
云南,2021,文科,511,407,95680
云南,2021,文科,482,406,96162
云南,2021,文科,501,405,96663
云南,2021,文科,496,404,97159
云南,2021,文科,511,403,97670
云南,2021,文科,494,402,98164
云南,2021,文科,471,401,98635
云南,2021,文科,492,400,99127
云南,2021,文科,461,399,99588
云南,2021,文科,461,398,100049
云南,2021,文科,473,397,100522
云南,2021,文科,478,396,101000
云南,2021,文科,437,395,101437
云南,2021,文科,432,394,101869
云南,2021,文科,448,393,102317
云南,2021,文科,444,392,102761
云南,2021,文科,406,391,103167
云南,2021,文科,419,390,103586
云南,2021,文科,438,389,104024
云南,2021,文科,418,388,104442
云南,2021,文科,439,387,104881
云南,2021,文科,396,386,105277
云南,2021,文科,360,385,105637
云南,2021,文科,410,384,106047
云南,2021,文科,412,383,106459
云南,2021,文科,395,382,106854
云南,2021,文科,377,381,107231
云南,2021,文科,340,380,107571
云南,2021,文科,391,379,107962
云南,2021,文科,358,378,108320
云南,2021,文科,341,377,108661
云南,2021,文科,336,376,108997
云南,2021,文科,346,375,109343
云南,2021,文科,335,374,109678
云南,2021,文科,299,373,109977
云南,2021,文科,336,372,110313
云南,2021,文科,310,371,110623
云南,2021,文科,321,370,110944
云南,2021,文科,333,369,111277
云南,2021,文科,314,368,111591
云南,2021,文科,313,367,111904
云南,2021,文科,318,366,112222
云南,2021,文科,297,365,112519
云南,2021,文科,297,364,112816
云南,2021,文科,277,363,113093
云南,2021,文科,297,362,113390
云南,2021,文科,289,361,113679
云南,2021,文科,266,360,113945
云南,2021,文科,258,359,114203
云南,2021,文科,256,358,114459
云南,2021,文科,226,357,114685
云南,2021,文科,246,356,114931
云南,2021,文科,261,355,115192
云南,2021,文科,235,354,115427
云南,2021,文科,239,353,115666
云南,2021,文科,248,352,115914
云南,2021,文科,205,351,116119
云南,2021,文科,239,350,116358
云南,2021,文科,235,349,116593
云南,2021,文科,234,348,116827
云南,2021,文科,185,347,117012
云南,2021,文科,210,346,117222
云南,2021,文科,206,345,117428
云南,2021,文科,191,344,117619
云南,2021,文科,183,343,117802
云南,2021,文科,195,342,117997
云南,2021,文科,213,341,118210
云南,2021,文科,192,340,118402
云南,2021,文科,180,339,118582
云南,2021,文科,153,338,118735
云南,2021,文科,154,337,118889
云南,2021,文科,189,336,119078
云南,2021,文科,169,335,119247
云南,2021,文科,160,334,119407
云南,2021,文科,134,333,119541
云南,2021,文科,144,332,119685
云南,2021,文科,146,331,119831
云南,2021,文科,138,330,119969
云南,2021,文科,138,329,120107
云南,2021,文科,139,328,120246
云南,2021,文科,142,327,120388
云南,2021,文科,105,326,120493
云南,2021,文科,127,325,120620
云南,2021,文科,124,324,120744
云南,2021,文科,122,323,120866
云南,2021,文科,126,322,120992
云南,2021,文科,114,321,121106
云南,2021,文科,108,320,121214
云南,2021,文科,105,319,121319
云南,2021,文科,99,318,121418
云南,2021,文科,89,317,121507
云南,2021,文科,109,316,121616
云南,2021,文科,93,315,121709
云南,2021,文科,70,314,121779
云南,2021,文科,82,313,121861
云南,2021,文科,86,312,121947
云南,2021,文科,78,311,122025
云南,2021,文科,86,310,122111
云南,2021,文科,72,309,122183
云南,2021,文科,70,308,122253
云南,2021,文科,76,307,122329
云南,2021,文科,62,306,122391
云南,2021,文科,78,305,122469
云南,2021,文科,67,304,122536
云南,2021,文科,55,303,122591
云南,2021,文科,60,302,122651
云南,2021,文科,61,301,122712
云南,2021,文科,55,300,122767
云南,2021,文科,54,299,122821
云南,2021,文科,54,298,122875
云南,2021,文科,51,297,122926
云南,2021,文科,45,296,122971
云南,2021,文科,44,295,123015
云南,2021,文科,46,294,123061
云南,2021,文科,42,293,123103
云南,2021,文科,60,292,123163
云南,2021,文科,51,291,123214
云南,2021,文科,36,290,123250
云南,2021,文科,44,289,123294
云南,2021,文科,33,288,123327
云南,2021,文科,37,287,123364
云南,2021,文科,38,286,123402
云南,2021,文科,23,285,123425
云南,2021,文科,31,284,123456
云南,2021,文科,36,283,123492
云南,2021,文科,38,282,123530
云南,2021,文科,36,281,123566
云南,2021,文科,33,280,123599
云南,2021,文科,20,279,123619
云南,2021,文科,24,278,123643
云南,2021,文科,34,277,123677
云南,2021,文科,19,276,123696
云南,2021,文科,16,275,123712
云南,2021,文科,22,274,123734
云南,2021,文科,16,273,123750
云南,2021,文科,20,272,123770
云南,2021,文科,14,271,123784
云南,2021,文科,18,270,123802
云南,2021,文科,13,269,123815
云南,2021,文科,15,268,123830
云南,2021,文科,11,267,123841
云南,2021,文科,20,266,123861
云南,2021,文科,19,265,123880
云南,2021,文科,17,264,123897
云南,2021,文科,14,263,123911
云南,2021,文科,14,262,123925
云南,2021,文科,15,261,123940
云南,2021,文科,17,260,123957
云南,2021,文科,13,259,123970
云南,2021,文科,11,258,123981
云南,2021,文科,16,257,123997
云南,2021,文科,10,256,124007
云南,2021,文科,10,255,124017
云南,2021,文科,6,254,124023
云南,2021,文科,9,253,124032
云南,2021,文科,10,252,124042
云南,2021,文科,7,251,124049
云南,2021,文科,11,250,124060
云南,2021,文科,10,249,124070
云南,2021,文科,2,248,124072
云南,2021,文科,7,247,124079
云南,2021,文科,8,246,124087
云南,2021,文科,7,245,124094
云南,2021,文科,8,244,124102
云南,2021,文科,13,243,124115
云南,2021,文科,8,242,124123
云南,2021,文科,5,241,124128
云南,2021,文科,5,240,124133
云南,2021,文科,6,239,124139
云南,2021,文科,4,238,124143
云南,2021,文科,5,237,124148
云南,2021,文科,3,236,124151
云南,2021,文科,11,235,124162
云南,2021,文科,5,234,124167
云南,2021,文科,5,233,124172
云南,2021,文科,6,232,124178
云南,2021,文科,2,231,124180
云南,2021,文科,3,230,124183
云南,2021,文科,2,229,124185
云南,2021,文科,4,228,124189
云南,2021,文科,3,227,124192
云南,2021,文科,4,226,124196
云南,2021,文科,2,225,124198
云南,2021,文科,5,224,124203
云南,2021,文科,4,223,124207
云南,2021,文科,4,222,124211
云南,2021,文科,4,221,124215
云南,2021,文科,4,220,124219
云南,2021,文科,1,219,124220
云南,2021,文科,3,218,124223
云南,2021,文科,4,217,124227
云南,2021,文科,5,215,124232
云南,2021,文科,2,214,124234
云南,2021,文科,3,213,124237
云南,2021,文科,1,212,124238
云南,2021,文科,4,211,124242
云南,2021,文科,4,209,124246
云南,2021,文科,1,208,124247
云南,2021,文科,2,207,124249
云南,2021,文科,1,206,124250
云南,2021,文科,2,205,124252
云南,2021,文科,1,204,124253
云南,2021,文科,2,203,124255
云南,2021,文科,4,202,124259
云南,2021,文科,2,201,124261
云南,2021,文科,1,200,124262
云南,2021,文科,17,190,124279
云南,2021,文科,10,180,124289
云南,2021,文科,11,170,124300
云南,2021,文科,8,160,124308
云南,2021,文科,9,150,124317
云南,2021,文科,9,140,124326
云南,2021,文科,3,130,124329
云南,2021,文科,6,120,124335
云南,2021,文科,3,110,124338
云南,2021,文科,3,100,124341
甘肃,2021,理科,37,669,37
甘肃,2021,理科,2,668,39
甘肃,2021,理科,1,667,40
甘肃,2021,理科,2,666,42
甘肃,2021,理科,6,665,48
甘肃,2021,理科,5,664,53
甘肃,2021,理科,5,663,58
甘肃,2021,理科,4,662,62
甘肃,2021,理科,6,661,68
甘肃,2021,理科,5,660,73
甘肃,2021,理科,5,659,78
甘肃,2021,理科,7,658,85
甘肃,2021,理科,4,657,89
甘肃,2021,理科,4,656,93
甘肃,2021,理科,6,655,99
甘肃,2021,理科,9,654,108
甘肃,2021,理科,4,653,112
甘肃,2021,理科,9,652,121
甘肃,2021,理科,3,651,124
甘肃,2021,理科,10,650,134
甘肃,2021,理科,8,649,142
甘肃,2021,理科,9,648,151
甘肃,2021,理科,7,647,158
甘肃,2021,理科,9,646,167
甘肃,2021,理科,14,645,181
甘肃,2021,理科,7,644,188
甘肃,2021,理科,14,643,202
甘肃,2021,理科,9,642,211
甘肃,2021,理科,17,641,228
甘肃,2021,理科,13,640,241
甘肃,2021,理科,9,639,250
甘肃,2021,理科,16,638,266
甘肃,2021,理科,11,637,277
甘肃,2021,理科,17,636,294
甘肃,2021,理科,16,635,310
甘肃,2021,理科,14,634,324
甘肃,2021,理科,9,633,333
甘肃,2021,理科,17,632,350
甘肃,2021,理科,21,631,371
甘肃,2021,理科,18,630,389
甘肃,2021,理科,30,629,419
甘肃,2021,理科,22,628,441
甘肃,2021,理科,30,627,471
甘肃,2021,理科,23,626,494
甘肃,2021,理科,26,625,520
甘肃,2021,理科,18,624,538
甘肃,2021,理科,17,623,555
甘肃,2021,理科,21,622,576
甘肃,2021,理科,27,621,603
甘肃,2021,理科,17,620,620
甘肃,2021,理科,37,619,657
甘肃,2021,理科,32,618,689
甘肃,2021,理科,36,617,725
甘肃,2021,理科,29,616,754
甘肃,2021,理科,36,615,790
甘肃,2021,理科,27,614,817
甘肃,2021,理科,37,613,854
甘肃,2021,理科,33,612,887
甘肃,2021,理科,34,611,921
甘肃,2021,理科,31,610,952
甘肃,2021,理科,34,609,986
甘肃,2021,理科,32,608,1018
甘肃,2021,理科,53,607,1071
甘肃,2021,理科,48,606,1119
甘肃,2021,理科,53,605,1172
甘肃,2021,理科,48,604,1220
甘肃,2021,理科,56,603,1276
甘肃,2021,理科,42,602,1318
甘肃,2021,理科,50,601,1368
甘肃,2021,理科,46,600,1414
甘肃,2021,理科,42,599,1456
甘肃,2021,理科,55,598,1511
甘肃,2021,理科,56,597,1567
甘肃,2021,理科,39,596,1606
甘肃,2021,理科,55,595,1661
甘肃,2021,理科,68,594,1729
甘肃,2021,理科,44,593,1773
甘肃,2021,理科,61,592,1834
甘肃,2021,理科,56,591,1890
甘肃,2021,理科,52,590,1942
甘肃,2021,理科,49,589,1991
甘肃,2021,理科,53,588,2044
甘肃,2021,理科,59,587,2103
甘肃,2021,理科,66,586,2169
甘肃,2021,理科,74,585,2243
甘肃,2021,理科,61,584,2304
甘肃,2021,理科,59,583,2363
甘肃,2021,理科,81,582,2444
甘肃,2021,理科,65,581,2509
甘肃,2021,理科,74,580,2583
甘肃,2021,理科,83,579,2666
甘肃,2021,理科,61,578,2727
甘肃,2021,理科,82,577,2809
甘肃,2021,理科,78,576,2887
甘肃,2021,理科,82,575,2969
甘肃,2021,理科,98,574,3067
甘肃,2021,理科,65,573,3132
甘肃,2021,理科,81,572,3213
甘肃,2021,理科,91,571,3304
甘肃,2021,理科,99,570,3403
甘肃,2021,理科,84,569,3487
甘肃,2021,理科,92,568,3579
甘肃,2021,理科,82,567,3661
甘肃,2021,理科,106,566,3767
甘肃,2021,理科,100,565,3867
甘肃,2021,理科,100,564,3967
甘肃,2021,理科,92,563,4059
甘肃,2021,理科,102,562,4161
甘肃,2021,理科,97,561,4258
甘肃,2021,理科,127,560,4385
甘肃,2021,理科,94,559,4479
甘肃,2021,理科,117,558,4596
甘肃,2021,理科,106,557,4702
甘肃,2021,理科,143,556,4845
甘肃,2021,理科,107,555,4952
甘肃,2021,理科,117,554,5069
甘肃,2021,理科,120,553,5189
甘肃,2021,理科,109,552,5298
甘肃,2021,理科,113,551,5411
甘肃,2021,理科,121,550,5532
甘肃,2021,理科,124,549,5656
甘肃,2021,理科,141,548,5797
甘肃,2021,理科,119,547,5916
甘肃,2021,理科,135,546,6051
甘肃,2021,理科,135,545,6186
甘肃,2021,理科,145,544,6331
甘肃,2021,理科,140,543,6471
甘肃,2021,理科,125,542,6596
甘肃,2021,理科,135,541,6731
甘肃,2021,理科,141,540,6872
甘肃,2021,理科,138,539,7010
甘肃,2021,理科,151,538,7161
甘肃,2021,理科,155,537,7316
甘肃,2021,理科,149,536,7465
甘肃,2021,理科,157,535,7622
甘肃,2021,理科,153,534,7775
甘肃,2021,理科,161,533,7936
甘肃,2021,理科,152,532,8088
甘肃,2021,理科,175,531,8263
甘肃,2021,理科,172,530,8435
甘肃,2021,理科,166,529,8601
甘肃,2021,理科,181,528,8782
甘肃,2021,理科,155,527,8937
甘肃,2021,理科,186,526,9123
甘肃,2021,理科,173,525,9296
甘肃,2021,理科,165,524,9461
甘肃,2021,理科,185,523,9646
甘肃,2021,理科,192,522,9838
甘肃,2021,理科,197,521,10035
甘肃,2021,理科,188,520,10223
甘肃,2021,理科,191,519,10414
甘肃,2021,理科,190,518,10604
甘肃,2021,理科,176,517,10780
甘肃,2021,理科,167,516,10947
甘肃,2021,理科,209,515,11156
甘肃,2021,理科,199,514,11355
甘肃,2021,理科,188,513,11543
甘肃,2021,理科,204,512,11747
甘肃,2021,理科,228,511,11975
甘肃,2021,理科,210,510,12185
甘肃,2021,理科,236,509,12421
甘肃,2021,理科,218,508,12639
甘肃,2021,理科,211,507,12850
甘肃,2021,理科,213,506,13063
甘肃,2021,理科,269,505,13332
甘肃,2021,理科,225,504,13557
甘肃,2021,理科,219,503,13776
甘肃,2021,理科,274,502,14050
甘肃,2021,理科,221,501,14271
甘肃,2021,理科,233,500,14504
甘肃,2021,理科,238,499,14742
甘肃,2021,理科,252,498,14994
甘肃,2021,理科,252,497,15246
甘肃,2021,理科,252,496,15498
甘肃,2021,理科,234,495,15732
甘肃,2021,理科,225,494,15957
甘肃,2021,理科,264,493,16221
甘肃,2021,理科,233,492,16454
甘肃,2021,理科,285,491,16739
甘肃,2021,理科,276,490,17015
甘肃,2021,理科,254,489,17269
甘肃,2021,理科,234,488,17503
甘肃,2021,理科,287,487,17790
甘肃,2021,理科,287,486,18077
甘肃,2021,理科,272,485,18349
甘肃,2021,理科,261,484,18610
甘肃,2021,理科,289,483,18899
甘肃,2021,理科,299,482,19198
甘肃,2021,理科,295,481,19493
甘肃,2021,理科,294,480,19787
甘肃,2021,理科,291,479,20078
甘肃,2021,理科,340,478,20418
甘肃,2021,理科,310,477,20728
甘肃,2021,理科,307,476,21035
甘肃,2021,理科,316,475,21351
甘肃,2021,理科,329,474,21680
甘肃,2021,理科,370,473,22050
甘肃,2021,理科,335,472,22385
甘肃,2021,理科,344,471,22729
甘肃,2021,理科,332,470,23061
甘肃,2021,理科,374,469,23435
甘肃,2021,理科,331,468,23766
甘肃,2021,理科,385,467,24151
甘肃,2021,理科,350,466,24501
甘肃,2021,理科,326,465,24827
甘肃,2021,理科,339,464,25166
甘肃,2021,理科,397,463,25563
甘肃,2021,理科,366,462,25929
甘肃,2021,理科,371,461,26300
甘肃,2021,理科,390,460,26690
甘肃,2021,理科,405,459,27095
甘肃,2021,理科,402,458,27497
甘肃,2021,理科,375,457,27872
甘肃,2021,理科,393,456,28265
甘肃,2021,理科,370,455,28635
甘肃,2021,理科,412,454,29047
甘肃,2021,理科,383,453,29430
甘肃,2021,理科,395,452,29825
甘肃,2021,理科,397,451,30222
甘肃,2021,理科,396,450,30618
甘肃,2021,理科,401,449,31019
甘肃,2021,理科,369,448,31388
甘肃,2021,理科,411,447,31799
甘肃,2021,理科,421,446,32220
甘肃,2021,理科,462,445,32682
甘肃,2021,理科,404,444,33086
甘肃,2021,理科,411,443,33497
甘肃,2021,理科,416,442,33913
甘肃,2021,理科,431,441,34344
甘肃,2021,理科,483,440,34827
甘肃,2021,理科,423,439,35250
甘肃,2021,理科,473,438,35723
甘肃,2021,理科,449,437,36172
甘肃,2021,理科,469,436,36641
甘肃,2021,理科,482,435,37123
甘肃,2021,理科,487,434,37610
甘肃,2021,理科,468,433,38078
甘肃,2021,理科,453,432,38531
甘肃,2021,理科,484,431,39015
甘肃,2021,理科,507,430,39522
甘肃,2021,理科,499,429,40021
甘肃,2021,理科,468,428,40489
甘肃,2021,理科,497,427,40986
甘肃,2021,理科,484,426,41470
甘肃,2021,理科,469,425,41939
甘肃,2021,理科,513,424,42452
甘肃,2021,理科,540,423,42992
甘肃,2021,理科,507,422,43499
甘肃,2021,理科,507,421,44006
甘肃,2021,理科,517,420,44523
甘肃,2021,理科,541,419,45064
甘肃,2021,理科,512,418,45576
甘肃,2021,理科,487,417,46063
甘肃,2021,理科,521,416,46584
甘肃,2021,理科,487,415,47071
甘肃,2021,理科,493,414,47564
甘肃,2021,理科,497,413,48061
甘肃,2021,理科,507,412,48568
甘肃,2021,理科,482,411,49050
甘肃,2021,理科,547,410,49597
甘肃,2021,理科,521,409,50118
甘肃,2021,理科,491,408,50609
甘肃,2021,理科,490,407,51099
甘肃,2021,理科,479,406,51578
甘肃,2021,理科,516,405,52094
甘肃,2021,理科,467,404,52561
甘肃,2021,理科,536,403,53097
甘肃,2021,理科,506,402,53603
甘肃,2021,理科,533,401,54136
甘肃,2021,理科,512,400,54648
甘肃,2021,理科,514,399,55162
甘肃,2021,理科,543,398,55705
甘肃,2021,理科,495,397,56200
甘肃,2021,理科,559,396,56759
甘肃,2021,理科,507,395,57266
甘肃,2021,理科,517,394,57783
甘肃,2021,理科,536,393,58319
甘肃,2021,理科,523,392,58842
甘肃,2021,理科,575,391,59417
甘肃,2021,理科,523,390,59940
甘肃,2021,理科,475,389,60415
甘肃,2021,理科,493,388,60908
甘肃,2021,理科,517,387,61425
甘肃,2021,理科,551,386,61976
甘肃,2021,理科,550,385,62526
甘肃,2021,理科,492,384,63018
甘肃,2021,理科,513,383,63531
甘肃,2021,理科,520,382,64051
甘肃,2021,理科,515,381,64566
甘肃,2021,理科,520,380,65086
甘肃,2021,理科,466,379,65552
甘肃,2021,理科,482,378,66034
甘肃,2021,理科,482,377,66516
甘肃,2021,理科,526,376,67042
甘肃,2021,理科,455,375,67497
甘肃,2021,理科,484,374,67981
甘肃,2021,理科,493,373,68474
甘肃,2021,理科,494,372,68968
甘肃,2021,理科,489,371,69457
甘肃,2021,理科,499,370,69956
甘肃,2021,理科,499,369,70455
甘肃,2021,理科,554,368,71009
甘肃,2021,理科,486,367,71495
甘肃,2021,理科,477,366,71972
甘肃,2021,理科,456,365,72428
甘肃,2021,理科,463,364,72891
甘肃,2021,理科,493,363,73384
甘肃,2021,理科,452,362,73836
甘肃,2021,理科,491,361,74327
甘肃,2021,理科,462,360,74789
甘肃,2021,理科,467,359,75256
甘肃,2021,理科,469,358,75725
甘肃,2021,理科,493,357,76218
甘肃,2021,理科,436,356,76654
甘肃,2021,理科,459,355,77113
甘肃,2021,理科,493,354,77606
甘肃,2021,理科,418,353,78024
甘肃,2021,理科,462,352,78486
甘肃,2021,理科,445,351,78931
甘肃,2021,理科,434,350,79365
甘肃,2021,理科,450,349,79815
甘肃,2021,理科,441,348,80256
甘肃,2021,理科,390,347,80646
甘肃,2021,理科,417,346,81063
甘肃,2021,理科,405,345,81468
甘肃,2021,理科,406,344,81874
甘肃,2021,理科,429,343,82303
甘肃,2021,理科,423,342,82726
甘肃,2021,理科,385,341,83111
甘肃,2021,理科,408,340,83519
甘肃,2021,理科,414,339,83933
甘肃,2021,理科,409,338,84342
甘肃,2021,理科,388,337,84730
甘肃,2021,理科,429,336,85159
甘肃,2021,理科,416,335,85575
甘肃,2021,理科,388,334,85963
甘肃,2021,理科,405,333,86368
甘肃,2021,理科,371,332,86739
甘肃,2021,理科,364,331,87103
甘肃,2021,理科,391,330,87494
甘肃,2021,理科,383,329,87877
甘肃,2021,理科,349,328,88226
甘肃,2021,理科,381,327,88607
甘肃,2021,理科,381,326,88988
甘肃,2021,理科,346,325,89334
甘肃,2021,理科,373,324,89707
甘肃,2021,理科,360,323,90067
甘肃,2021,理科,366,322,90433
甘肃,2021,理科,368,321,90801
甘肃,2021,理科,328,320,91129
甘肃,2021,理科,344,319,91473
甘肃,2021,理科,355,318,91828
甘肃,2021,理科,326,317,92154
甘肃,2021,理科,336,316,92490
甘肃,2021,理科,315,315,92805
甘肃,2021,理科,321,314,93126
甘肃,2021,理科,302,313,93428
甘肃,2021,理科,303,312,93731
甘肃,2021,理科,311,311,94042
甘肃,2021,理科,300,310,94342
甘肃,2021,理科,296,309,94638
甘肃,2021,理科,315,308,94953
甘肃,2021,理科,289,307,95242
甘肃,2021,理科,295,306,95537
甘肃,2021,理科,289,305,95826
甘肃,2021,理科,285,304,96111
甘肃,2021,理科,309,303,96420
甘肃,2021,理科,257,302,96677
甘肃,2021,理科,287,301,96964
甘肃,2021,理科,286,300,97250
甘肃,2021,理科,291,299,97541
甘肃,2021,理科,223,298,97764
甘肃,2021,理科,253,297,98017
甘肃,2021,理科,257,296,98274
甘肃,2021,理科,250,295,98524
甘肃,2021,理科,271,294,98795
甘肃,2021,理科,251,293,99046
甘肃,2021,理科,244,292,99290
甘肃,2021,理科,262,291,99552
甘肃,2021,理科,244,290,99796
甘肃,2021,理科,257,289,100053
甘肃,2021,理科,221,288,100274
甘肃,2021,理科,200,287,100474
甘肃,2021,理科,250,286,100724
甘肃,2021,理科,225,285,100949
甘肃,2021,理科,207,284,101156
甘肃,2021,理科,224,283,101380
甘肃,2021,理科,195,282,101575
甘肃,2021,理科,232,281,101807
甘肃,2021,理科,226,280,102033
甘肃,2021,理科,206,279,102239
甘肃,2021,理科,223,278,102462
甘肃,2021,理科,189,277,102651
甘肃,2021,理科,213,276,102864
甘肃,2021,理科,201,275,103065
甘肃,2021,理科,179,274,103244
甘肃,2021,理科,173,273,103417
甘肃,2021,理科,199,272,103616
甘肃,2021,理科,214,271,103830
甘肃,2021,理科,175,270,104005
甘肃,2021,理科,180,269,104185
甘肃,2021,理科,175,268,104360
甘肃,2021,理科,199,267,104559
甘肃,2021,理科,187,266,104746
甘肃,2021,理科,180,265,104926
甘肃,2021,理科,159,264,105085
甘肃,2021,理科,171,263,105256
甘肃,2021,理科,168,262,105424
甘肃,2021,理科,180,261,105604
甘肃,2021,理科,167,260,105771
甘肃,2021,理科,139,259,105910
甘肃,2021,理科,148,258,106058
甘肃,2021,理科,134,257,106192
甘肃,2021,理科,161,256,106353
甘肃,2021,理科,157,255,106510
甘肃,2021,理科,142,254,106652
甘肃,2021,理科,152,253,106804
甘肃,2021,理科,133,252,106937
甘肃,2021,理科,118,251,107055
甘肃,2021,理科,120,250,107175
甘肃,2021,理科,140,249,107315
甘肃,2021,理科,128,248,107443
甘肃,2021,理科,132,247,107575
甘肃,2021,理科,116,246,107691
甘肃,2021,理科,117,245,107808
甘肃,2021,理科,110,244,107918
甘肃,2021,理科,137,243,108055
甘肃,2021,理科,118,242,108173
甘肃,2021,理科,117,241,108290
甘肃,2021,理科,100,240,108390
甘肃,2021,理科,123,239,108513
甘肃,2021,理科,94,238,108607
甘肃,2021,理科,104,237,108711
甘肃,2021,理科,94,236,108805
甘肃,2021,理科,112,235,108917
甘肃,2021,理科,103,234,109020
甘肃,2021,理科,95,233,109115
甘肃,2021,理科,84,232,109199
甘肃,2021,理科,95,231,109294
甘肃,2021,理科,92,230,109386
甘肃,2021,理科,110,229,109496
甘肃,2021,理科,90,228,109586
甘肃,2021,理科,83,227,109669
甘肃,2021,理科,79,226,109748
甘肃,2021,理科,77,225,109825
甘肃,2021,理科,81,224,109906
甘肃,2021,理科,89,223,109995
甘肃,2021,理科,75,222,110070
甘肃,2021,理科,65,221,110135
甘肃,2021,理科,71,220,110206
甘肃,2021,理科,62,219,110268
甘肃,2021,理科,57,218,110325
甘肃,2021,理科,58,217,110383
甘肃,2021,理科,75,216,110458
甘肃,2021,理科,54,215,110512
甘肃,2021,理科,58,214,110570
甘肃,2021,理科,67,213,110637
甘肃,2021,理科,57,212,110694
甘肃,2021,理科,62,211,110756
甘肃,2021,理科,55,210,110811
甘肃,2021,理科,58,209,110869
甘肃,2021,理科,63,208,110932
甘肃,2021,理科,52,207,110984
甘肃,2021,理科,56,206,111040
甘肃,2021,理科,61,205,111101
甘肃,2021,理科,47,204,111148
甘肃,2021,理科,44,203,111192
甘肃,2021,理科,47,202,111239
甘肃,2021,理科,42,201,111281
甘肃,2021,理科,46,200,111327
甘肃,2021,理科,35,199,111362
甘肃,2021,理科,51,198,111413
甘肃,2021,理科,42,197,111455
甘肃,2021,理科,45,196,111500
甘肃,2021,理科,34,195,111534
甘肃,2021,理科,41,194,111575
甘肃,2021,理科,34,193,111609
甘肃,2021,理科,34,192,111643
甘肃,2021,理科,35,191,111678
甘肃,2021,理科,39,190,111717
甘肃,2021,理科,37,189,111754
甘肃,2021,理科,24,188,111778
甘肃,2021,理科,35,187,111813
甘肃,2021,理科,25,186,111838
甘肃,2021,理科,17,185,111855
甘肃,2021,理科,25,184,111880
甘肃,2021,理科,22,183,111902
甘肃,2021,理科,16,182,111918
甘肃,2021,理科,21,181,111939
甘肃,2021,理科,22,180,111961
甘肃,2021,理科,20,179,111981
甘肃,2021,理科,21,178,112002
甘肃,2021,理科,20,177,112022
甘肃,2021,理科,23,176,112045
甘肃,2021,理科,15,175,112060
甘肃,2021,理科,14,174,112074
甘肃,2021,理科,12,173,112086
甘肃,2021,理科,12,172,112098
甘肃,2021,理科,9,171,112107
甘肃,2021,理科,16,170,112123
甘肃,2021,理科,7,169,112130
甘肃,2021,理科,14,168,112144
甘肃,2021,理科,16,167,112160
甘肃,2021,理科,6,166,112166
甘肃,2021,理科,6,165,112172
甘肃,2021,理科,11,164,112183
甘肃,2021,理科,7,163,112190
甘肃,2021,理科,8,162,112198
甘肃,2021,理科,12,161,112210
甘肃,2021,理科,6,160,112216
甘肃,2021,理科,10,159,112226
甘肃,2021,理科,7,158,112233
甘肃,2021,理科,12,157,112245
甘肃,2021,理科,6,156,112251
甘肃,2021,理科,3,155,112254
甘肃,2021,理科,2,154,112256
甘肃,2021,理科,6,153,112262
甘肃,2021,理科,5,152,112267
甘肃,2021,理科,6,151,112273
甘肃,2021,理科,6,150,112279
甘肃,2021,理科,5,149,112284
甘肃,2021,理科,2,148,112286
甘肃,2021,理科,6,147,112292
甘肃,2021,理科,1,146,112293
甘肃,2021,理科,4,145,112297
甘肃,2021,理科,2,144,112299
甘肃,2021,理科,2,143,112301
甘肃,2021,理科,1,142,112302
甘肃,2021,理科,2,141,112304
甘肃,2021,理科,2,140,112306
甘肃,2021,理科,4,139,112310
甘肃,2021,理科,1,138,112311
甘肃,2021,理科,1,137,112312
甘肃,2021,理科,3,135,112315
甘肃,2021,理科,3,134,112318
甘肃,2021,理科,1,133,112319
甘肃,2021,理科,1,132,112320
甘肃,2021,理科,3,131,112323
甘肃,2021,理科,1,130,112324
甘肃,2021,理科,1,129,112325
甘肃,2021,理科,2,125,112327
甘肃,2021,理科,1,124,112328
甘肃,2021,理科,2,123,112330
甘肃,2021,理科,1,122,112331
甘肃,2021,理科,2,121,112333
甘肃,2021,理科,1,118,112334
甘肃,2021,理科,3,116,112337
甘肃,2021,理科,3,108,112340
甘肃,2021,理科,1,107,112341
甘肃,2021,理科,1,106,112342
甘肃,2021,理科,1,104,112343
甘肃,2021,理科,1,101,112344
甘肃,2021,理科,1,100,112345
甘肃,2021,理科,1,99,112346
甘肃,2021,理科,2,96,112348
甘肃,2021,理科,1,95,112349
甘肃,2021,理科,1,92,112350
甘肃,2021,理科,1,91,112351
甘肃,2021,理科,1,90,112352
甘肃,2021,理科,2,80,112354
甘肃,2021,理科,1,77,112355
甘肃,2021,理科,1,59,112356
甘肃,2021,理科,1,50,112357
甘肃,2021,理科,1,46,112358
甘肃,2021,理科,1,34,112359
甘肃,2021,理科,1,28,112360
甘肃,2021,理科,1,20,112361
甘肃,2021,理科,1,15,112362
甘肃,2021,理科,1,14,112363
甘肃,2021,理科,1,9,112364
甘肃,2021,文科,16,647,16
甘肃,2021,文科,1,646,17
甘肃,2021,文科,2,645,19
甘肃,2021,文科,1,644,20
甘肃,2021,文科,5,643,25
甘肃,2021,文科,3,642,28
甘肃,2021,文科,2,641,30
甘肃,2021,文科,2,640,32
甘肃,2021,文科,1,639,33
甘肃,2021,文科,2,638,35
甘肃,2021,文科,2,637,37
甘肃,2021,文科,1,636,38
甘肃,2021,文科,4,635,42
甘肃,2021,文科,3,634,45
甘肃,2021,文科,4,633,49
甘肃,2021,文科,7,632,56
甘肃,2021,文科,1,631,57
甘肃,2021,文科,8,630,65
甘肃,2021,文科,5,629,70
甘肃,2021,文科,1,628,71
甘肃,2021,文科,3,627,74
甘肃,2021,文科,2,626,76
甘肃,2021,文科,4,625,80
甘肃,2021,文科,7,624,87
甘肃,2021,文科,4,623,91
甘肃,2021,文科,10,622,101
甘肃,2021,文科,8,621,109
甘肃,2021,文科,10,620,119
甘肃,2021,文科,6,619,125
甘肃,2021,文科,10,618,135
甘肃,2021,文科,7,617,142
甘肃,2021,文科,9,616,151
甘肃,2021,文科,9,615,160
甘肃,2021,文科,7,614,167
甘肃,2021,文科,16,613,183
甘肃,2021,文科,9,612,192
甘肃,2021,文科,10,611,202
甘肃,2021,文科,8,610,210
甘肃,2021,文科,10,609,220
甘肃,2021,文科,9,608,229
甘肃,2021,文科,10,607,239
甘肃,2021,文科,9,606,248
甘肃,2021,文科,8,605,256
甘肃,2021,文科,13,604,269
甘肃,2021,文科,13,603,282
甘肃,2021,文科,16,602,298
甘肃,2021,文科,14,601,312
甘肃,2021,文科,15,600,327
甘肃,2021,文科,15,599,342
甘肃,2021,文科,15,598,357
甘肃,2021,文科,11,597,368
甘肃,2021,文科,15,596,383
甘肃,2021,文科,18,595,401
甘肃,2021,文科,24,594,425
甘肃,2021,文科,24,593,449
甘肃,2021,文科,19,592,468
甘肃,2021,文科,28,591,496
甘肃,2021,文科,26,590,522
甘肃,2021,文科,25,589,547
甘肃,2021,文科,23,588,570
甘肃,2021,文科,27,587,597
甘肃,2021,文科,27,586,624
甘肃,2021,文科,34,585,658
甘肃,2021,文科,33,584,691
甘肃,2021,文科,22,583,713
甘肃,2021,文科,32,582,745
甘肃,2021,文科,34,581,779
甘肃,2021,文科,23,580,802
甘肃,2021,文科,27,579,829
甘肃,2021,文科,31,578,860
甘肃,2021,文科,41,577,901
甘肃,2021,文科,30,576,931
甘肃,2021,文科,33,575,964
甘肃,2021,文科,39,574,1003
甘肃,2021,文科,59,573,1062
甘肃,2021,文科,32,572,1094
甘肃,2021,文科,51,571,1145
甘肃,2021,文科,56,570,1201
甘肃,2021,文科,42,569,1243
甘肃,2021,文科,42,568,1285
甘肃,2021,文科,32,567,1317
甘肃,2021,文科,39,566,1356
甘肃,2021,文科,39,565,1395
甘肃,2021,文科,48,564,1443
甘肃,2021,文科,44,563,1487
甘肃,2021,文科,47,562,1534
甘肃,2021,文科,51,561,1585
甘肃,2021,文科,53,560,1638
甘肃,2021,文科,50,559,1688
甘肃,2021,文科,40,558,1728
甘肃,2021,文科,47,557,1775
甘肃,2021,文科,43,556,1818
甘肃,2021,文科,40,555,1858
甘肃,2021,文科,55,554,1913
甘肃,2021,文科,68,553,1981
甘肃,2021,文科,64,552,2045
甘肃,2021,文科,57,551,2102
甘肃,2021,文科,60,550,2162
甘肃,2021,文科,85,549,2247
甘肃,2021,文科,62,548,2309
甘肃,2021,文科,75,547,2384
甘肃,2021,文科,69,546,2453
甘肃,2021,文科,90,545,2543
甘肃,2021,文科,73,544,2616
甘肃,2021,文科,79,543,2695
甘肃,2021,文科,90,542,2785
甘肃,2021,文科,77,541,2862
甘肃,2021,文科,85,540,2947
甘肃,2021,文科,69,539,3016
甘肃,2021,文科,71,538,3087
甘肃,2021,文科,97,537,3184
甘肃,2021,文科,94,536,3278
甘肃,2021,文科,91,535,3369
甘肃,2021,文科,89,534,3458
甘肃,2021,文科,96,533,3554
甘肃,2021,文科,85,532,3639
甘肃,2021,文科,104,531,3743
甘肃,2021,文科,117,530,3860
甘肃,2021,文科,106,529,3966
甘肃,2021,文科,121,528,4087
甘肃,2021,文科,105,527,4192
甘肃,2021,文科,123,526,4315
甘肃,2021,文科,117,525,4432
甘肃,2021,文科,113,524,4545
甘肃,2021,文科,144,523,4689
甘肃,2021,文科,131,522,4820
甘肃,2021,文科,129,521,4949
甘肃,2021,文科,143,520,5092
甘肃,2021,文科,136,519,5228
甘肃,2021,文科,142,518,5370
甘肃,2021,文科,134,517,5504
甘肃,2021,文科,130,516,5634
甘肃,2021,文科,143,515,5777
甘肃,2021,文科,131,514,5908
甘肃,2021,文科,161,513,6069
甘肃,2021,文科,174,512,6243
甘肃,2021,文科,176,511,6419
甘肃,2021,文科,165,510,6584
甘肃,2021,文科,174,509,6758
甘肃,2021,文科,172,508,6930
甘肃,2021,文科,186,507,7116
甘肃,2021,文科,177,506,7293
甘肃,2021,文科,173,505,7466
甘肃,2021,文科,209,504,7675
甘肃,2021,文科,175,503,7850
甘肃,2021,文科,176,502,8026
甘肃,2021,文科,209,501,8235
甘肃,2021,文科,193,500,8428
甘肃,2021,文科,198,499,8626
甘肃,2021,文科,185,498,8811
甘肃,2021,文科,215,497,9026
甘肃,2021,文科,228,496,9254
甘肃,2021,文科,197,495,9451
甘肃,2021,文科,194,494,9645
甘肃,2021,文科,196,493,9841
甘肃,2021,文科,223,492,10064
甘肃,2021,文科,220,491,10284
甘肃,2021,文科,223,490,10507
甘肃,2021,文科,240,489,10747
甘肃,2021,文科,227,488,10974
甘肃,2021,文科,231,487,11205
甘肃,2021,文科,266,486,11471
甘肃,2021,文科,247,485,11718
甘肃,2021,文科,219,484,11937
甘肃,2021,文科,260,483,12197
甘肃,2021,文科,264,482,12461
甘肃,2021,文科,259,481,12720
甘肃,2021,文科,258,480,12978
甘肃,2021,文科,217,479,13195
甘肃,2021,文科,255,478,13450
甘肃,2021,文科,262,477,13712
甘肃,2021,文科,259,476,13971
甘肃,2021,文科,254,475,14225
甘肃,2021,文科,274,474,14499
甘肃,2021,文科,264,473,14763
甘肃,2021,文科,251,472,15014
甘肃,2021,文科,261,471,15275
甘肃,2021,文科,272,470,15547
甘肃,2021,文科,264,469,15811
甘肃,2021,文科,254,468,16065
甘肃,2021,文科,285,467,16350
甘肃,2021,文科,272,466,16622
甘肃,2021,文科,278,465,16900
甘肃,2021,文科,312,464,17212
甘肃,2021,文科,258,463,17470
甘肃,2021,文科,290,462,17760
甘肃,2021,文科,282,461,18042
甘肃,2021,文科,309,460,18351
甘肃,2021,文科,300,459,18651
甘肃,2021,文科,280,458,18931
甘肃,2021,文科,288,457,19219
甘肃,2021,文科,270,456,19489
甘肃,2021,文科,303,455,19792
甘肃,2021,文科,310,454,20102
甘肃,2021,文科,292,453,20394
甘肃,2021,文科,320,452,20714
甘肃,2021,文科,353,451,21067
甘肃,2021,文科,294,450,21361
甘肃,2021,文科,263,449,21624
甘肃,2021,文科,307,448,21931
甘肃,2021,文科,311,447,22242
甘肃,2021,文科,306,446,22548
甘肃,2021,文科,294,445,22842
甘肃,2021,文科,324,444,23166
甘肃,2021,文科,321,443,23487
甘肃,2021,文科,305,442,23792
甘肃,2021,文科,317,441,24109
甘肃,2021,文科,304,440,24413
甘肃,2021,文科,308,439,24721
甘肃,2021,文科,327,438,25048
甘肃,2021,文科,325,437,25373
甘肃,2021,文科,284,436,25657
甘肃,2021,文科,291,435,25948
甘肃,2021,文科,297,434,26245
甘肃,2021,文科,291,433,26536
甘肃,2021,文科,285,432,26821
甘肃,2021,文科,305,431,27126
甘肃,2021,文科,312,430,27438
甘肃,2021,文科,317,429,27755
甘肃,2021,文科,310,428,28065
甘肃,2021,文科,296,427,28361
甘肃,2021,文科,278,426,28639
甘肃,2021,文科,335,425,28974
甘肃,2021,文科,304,424,29278
甘肃,2021,文科,288,423,29566
甘肃,2021,文科,311,422,29877
甘肃,2021,文科,308,421,30185
甘肃,2021,文科,287,420,30472
甘肃,2021,文科,286,419,30758
甘肃,2021,文科,308,418,31066
甘肃,2021,文科,312,417,31378
甘肃,2021,文科,319,416,31697
甘肃,2021,文科,319,415,32016
甘肃,2021,文科,282,414,32298
甘肃,2021,文科,297,413,32595
甘肃,2021,文科,316,412,32911
甘肃,2021,文科,271,411,33182
甘肃,2021,文科,309,410,33491
甘肃,2021,文科,294,409,33785
甘肃,2021,文科,283,408,34068
甘肃,2021,文科,266,407,34334
甘肃,2021,文科,286,406,34620
甘肃,2021,文科,318,405,34938
甘肃,2021,文科,328,404,35266
甘肃,2021,文科,316,403,35582
甘肃,2021,文科,293,402,35875
甘肃,2021,文科,314,401,36189
甘肃,2021,文科,286,400,36475
甘肃,2021,文科,276,399,36751
甘肃,2021,文科,326,398,37077
甘肃,2021,文科,301,397,37378
甘肃,2021,文科,294,396,37672
甘肃,2021,文科,267,395,37939
甘肃,2021,文科,280,394,38219
甘肃,2021,文科,313,393,38532
甘肃,2021,文科,299,392,38831
甘肃,2021,文科,310,391,39141
甘肃,2021,文科,295,390,39436
甘肃,2021,文科,297,389,39733
甘肃,2021,文科,280,388,40013
甘肃,2021,文科,285,387,40298
甘肃,2021,文科,286,386,40584
甘肃,2021,文科,324,385,40908
甘肃,2021,文科,286,384,41194
甘肃,2021,文科,304,383,41498
甘肃,2021,文科,316,382,41814
甘肃,2021,文科,297,381,42111
甘肃,2021,文科,287,380,42398
甘肃,2021,文科,300,379,42698
甘肃,2021,文科,293,378,42991
甘肃,2021,文科,256,377,43247
甘肃,2021,文科,298,376,43545
甘肃,2021,文科,295,375,43840
甘肃,2021,文科,279,374,44119
甘肃,2021,文科,277,373,44396
甘肃,2021,文科,283,372,44679
甘肃,2021,文科,278,371,44957
甘肃,2021,文科,285,370,45242
甘肃,2021,文科,276,369,45518
甘肃,2021,文科,271,368,45789
甘肃,2021,文科,254,367,46043
甘肃,2021,文科,299,366,46342
甘肃,2021,文科,328,365,46670
甘肃,2021,文科,306,364,46976
甘肃,2021,文科,280,363,47256
甘肃,2021,文科,307,362,47563
甘肃,2021,文科,291,361,47854
甘肃,2021,文科,275,360,48129
甘肃,2021,文科,267,359,48396
甘肃,2021,文科,303,358,48699
甘肃,2021,文科,321,357,49020
甘肃,2021,文科,296,356,49316
甘肃,2021,文科,258,355,49574
甘肃,2021,文科,279,354,49853
甘肃,2021,文科,277,353,50130
甘肃,2021,文科,269,352,50399
甘肃,2021,文科,288,351,50687
甘肃,2021,文科,320,350,51007
甘肃,2021,文科,297,349,51304
甘肃,2021,文科,296,348,51600
甘肃,2021,文科,306,347,51906
甘肃,2021,文科,287,346,52193
甘肃,2021,文科,319,345,52512
甘肃,2021,文科,313,344,52825
甘肃,2021,文科,309,343,53134
甘肃,2021,文科,300,342,53434
甘肃,2021,文科,282,341,53716
甘肃,2021,文科,295,340,54011
甘肃,2021,文科,268,339,54279
甘肃,2021,文科,296,338,54575
甘肃,2021,文科,307,337,54882
甘肃,2021,文科,323,336,55205
甘肃,2021,文科,325,335,55530
甘肃,2021,文科,308,334,55838
甘肃,2021,文科,289,333,56127
甘肃,2021,文科,315,332,56442
甘肃,2021,文科,291,331,56733
甘肃,2021,文科,302,330,57035
甘肃,2021,文科,330,329,57365
甘肃,2021,文科,315,328,57680
甘肃,2021,文科,305,327,57985
甘肃,2021,文科,298,326,58283
甘肃,2021,文科,315,325,58598
甘肃,2021,文科,305,324,58903
甘肃,2021,文科,293,323,59196
甘肃,2021,文科,353,322,59549
甘肃,2021,文科,328,321,59877
甘肃,2021,文科,318,320,60195
甘肃,2021,文科,327,319,60522
甘肃,2021,文科,336,318,60858
甘肃,2021,文科,292,317,61150
甘肃,2021,文科,312,316,61462
甘肃,2021,文科,314,315,61776
甘肃,2021,文科,324,314,62100
甘肃,2021,文科,290,313,62390
甘肃,2021,文科,295,312,62685
甘肃,2021,文科,282,311,62967
甘肃,2021,文科,306,310,63273
甘肃,2021,文科,296,309,63569
甘肃,2021,文科,268,308,63837
甘肃,2021,文科,337,307,64174
甘肃,2021,文科,304,306,64478
甘肃,2021,文科,293,305,64771
甘肃,2021,文科,316,304,65087
甘肃,2021,文科,299,303,65386
甘肃,2021,文科,303,302,65689
甘肃,2021,文科,283,301,65972
甘肃,2021,文科,310,300,66282
甘肃,2021,文科,295,299,66577
甘肃,2021,文科,307,298,66884
甘肃,2021,文科,296,297,67180
甘肃,2021,文科,316,296,67496
甘肃,2021,文科,286,295,67782
甘肃,2021,文科,294,294,68076
甘肃,2021,文科,267,293,68343
甘肃,2021,文科,282,292,68625
甘肃,2021,文科,265,291,68890
甘肃,2021,文科,276,290,69166
甘肃,2021,文科,291,289,69457
甘肃,2021,文科,311,288,69768
甘肃,2021,文科,264,287,70032
甘肃,2021,文科,304,286,70336
甘肃,2021,文科,268,285,70604
甘肃,2021,文科,282,284,70886
甘肃,2021,文科,274,283,71160
甘肃,2021,文科,268,282,71428
甘肃,2021,文科,264,281,71692
甘肃,2021,文科,268,280,71960
甘肃,2021,文科,223,279,72183
甘肃,2021,文科,266,278,72449
甘肃,2021,文科,226,277,72675
甘肃,2021,文科,220,276,72895
甘肃,2021,文科,225,275,73120
甘肃,2021,文科,261,274,73381
甘肃,2021,文科,245,273,73626
甘肃,2021,文科,216,272,73842
甘肃,2021,文科,220,271,74062
甘肃,2021,文科,208,270,74270
甘肃,2021,文科,222,269,74492
甘肃,2021,文科,207,268,74699
甘肃,2021,文科,228,267,74927
甘肃,2021,文科,202,266,75129
甘肃,2021,文科,201,265,75330
甘肃,2021,文科,182,264,75512
甘肃,2021,文科,218,263,75730
甘肃,2021,文科,185,262,75915
甘肃,2021,文科,181,261,76096
甘肃,2021,文科,180,260,76276
甘肃,2021,文科,182,259,76458
甘肃,2021,文科,171,258,76629
甘肃,2021,文科,172,257,76801
甘肃,2021,文科,173,256,76974
甘肃,2021,文科,165,255,77139
甘肃,2021,文科,187,254,77326
甘肃,2021,文科,160,253,77486
甘肃,2021,文科,167,252,77653
甘肃,2021,文科,154,251,77807
甘肃,2021,文科,154,250,77961
甘肃,2021,文科,132,249,78093
甘肃,2021,文科,143,248,78236
甘肃,2021,文科,138,247,78374
甘肃,2021,文科,134,246,78508
甘肃,2021,文科,135,245,78643
甘肃,2021,文科,128,244,78771
甘肃,2021,文科,126,243,78897
甘肃,2021,文科,134,242,79031
甘肃,2021,文科,109,241,79140
甘肃,2021,文科,111,240,79251
甘肃,2021,文科,97,239,79348
甘肃,2021,文科,108,238,79456
甘肃,2021,文科,82,237,79538
甘肃,2021,文科,89,236,79627
甘肃,2021,文科,95,235,79722
甘肃,2021,文科,84,234,79806
甘肃,2021,文科,80,233,79886
甘肃,2021,文科,97,232,79983
甘肃,2021,文科,79,231,80062
甘肃,2021,文科,86,230,80148
甘肃,2021,文科,97,229,80245
甘肃,2021,文科,62,228,80307
甘肃,2021,文科,74,227,80381
甘肃,2021,文科,68,226,80449
甘肃,2021,文科,67,225,80516
甘肃,2021,文科,71,224,80587
甘肃,2021,文科,59,223,80646
甘肃,2021,文科,56,222,80702
甘肃,2021,文科,63,221,80765
甘肃,2021,文科,51,220,80816
甘肃,2021,文科,44,219,80860
甘肃,2021,文科,52,218,80912
甘肃,2021,文科,57,217,80969
甘肃,2021,文科,56,216,81025
甘肃,2021,文科,56,215,81081
甘肃,2021,文科,41,214,81122
甘肃,2021,文科,47,213,81169
甘肃,2021,文科,44,212,81213
甘肃,2021,文科,36,211,81249
甘肃,2021,文科,47,210,81296
甘肃,2021,文科,50,209,81346
甘肃,2021,文科,42,208,81388
甘肃,2021,文科,32,207,81420
甘肃,2021,文科,40,206,81460
甘肃,2021,文科,37,205,81497
甘肃,2021,文科,28,204,81525
甘肃,2021,文科,26,203,81551
甘肃,2021,文科,20,202,81571
甘肃,2021,文科,29,201,81600
甘肃,2021,文科,32,200,81632
甘肃,2021,文科,13,199,81645
甘肃,2021,文科,23,198,81668
甘肃,2021,文科,22,197,81690
甘肃,2021,文科,24,196,81714
甘肃,2021,文科,22,195,81736
甘肃,2021,文科,25,194,81761
甘肃,2021,文科,23,193,81784
甘肃,2021,文科,16,192,81800
甘肃,2021,文科,22,191,81822
甘肃,2021,文科,15,190,81837
甘肃,2021,文科,22,189,81859
甘肃,2021,文科,22,188,81881
甘肃,2021,文科,14,187,81895
甘肃,2021,文科,18,186,81913
甘肃,2021,文科,16,185,81929
甘肃,2021,文科,17,184,81946
甘肃,2021,文科,9,183,81955
甘肃,2021,文科,16,182,81971
甘肃,2021,文科,16,181,81987
甘肃,2021,文科,9,180,81996
甘肃,2021,文科,14,179,82010
甘肃,2021,文科,16,178,82026
甘肃,2021,文科,19,177,82045
甘肃,2021,文科,7,176,82052
甘肃,2021,文科,9,175,82061
甘肃,2021,文科,5,174,82066
甘肃,2021,文科,11,173,82077
甘肃,2021,文科,2,172,82079
甘肃,2021,文科,10,171,82089
甘肃,2021,文科,3,170,82092
甘肃,2021,文科,12,169,82104
甘肃,2021,文科,3,168,82107
甘肃,2021,文科,6,167,82113
甘肃,2021,文科,13,166,82126
甘肃,2021,文科,7,165,82133
甘肃,2021,文科,7,164,82140
甘肃,2021,文科,3,163,82143
甘肃,2021,文科,8,162,82151
甘肃,2021,文科,9,161,82160
甘肃,2021,文科,4,160,82164
甘肃,2021,文科,5,159,82169
甘肃,2021,文科,4,158,82173
甘肃,2021,文科,6,157,82179
甘肃,2021,文科,6,156,82185
甘肃,2021,文科,4,155,82189
甘肃,2021,文科,7,154,82196
甘肃,2021,文科,5,153,82201
甘肃,2021,文科,2,152,82203
甘肃,2021,文科,5,151,82208
甘肃,2021,文科,5,150,82213
甘肃,2021,文科,6,149,82219
甘肃,2021,文科,5,148,82224
甘肃,2021,文科,6,147,82230
甘肃,2021,文科,3,146,82233
甘肃,2021,文科,4,145,82237
甘肃,2021,文科,6,144,82243
甘肃,2021,文科,5,143,82248
甘肃,2021,文科,5,142,82253
甘肃,2021,文科,3,140,82256
甘肃,2021,文科,1,139,82257
甘肃,2021,文科,4,138,82261
甘肃,2021,文科,4,137,82265
甘肃,2021,文科,2,136,82267
甘肃,2021,文科,3,135,82270
甘肃,2021,文科,4,133,82274
甘肃,2021,文科,1,131,82275
甘肃,2021,文科,4,129,82279
甘肃,2021,文科,4,126,82283
甘肃,2021,文科,2,125,82285
甘肃,2021,文科,4,124,82289
甘肃,2021,文科,1,123,82290
甘肃,2021,文科,1,122,82291
甘肃,2021,文科,1,121,82292
甘肃,2021,文科,4,120,82296
甘肃,2021,文科,2,119,82298
甘肃,2021,文科,1,118,82299
甘肃,2021,文科,4,117,82303
甘肃,2021,文科,2,116,82305
甘肃,2021,文科,4,115,82309
甘肃,2021,文科,2,113,82311
甘肃,2021,文科,1,112,82312
甘肃,2021,文科,1,111,82313
甘肃,2021,文科,1,110,82314
甘肃,2021,文科,1,109,82315
甘肃,2021,文科,1,108,82316
甘肃,2021,文科,2,107,82318
甘肃,2021,文科,5,105,82323
甘肃,2021,文科,2,103,82325
甘肃,2021,文科,1,102,82326
甘肃,2021,文科,2,101,82328
甘肃,2021,文科,1,100,82329
甘肃,2021,文科,2,99,82331
甘肃,2021,文科,3,98,82334
甘肃,2021,文科,2,96,82336
甘肃,2021,文科,2,95,82338
甘肃,2021,文科,2,94,82340
甘肃,2021,文科,1,93,82341
甘肃,2021,文科,3,91,82344
甘肃,2021,文科,3,90,82347
甘肃,2021,文科,3,89,82350
甘肃,2021,文科,3,88,82353
甘肃,2021,文科,5,87,82358
甘肃,2021,文科,2,86,82360
甘肃,2021,文科,2,85,82362
甘肃,2021,文科,2,84,82364
甘肃,2021,文科,1,83,82365
甘肃,2021,文科,1,81,82366
甘肃,2021,文科,2,80,82368
甘肃,2021,文科,1,79,82369
甘肃,2021,文科,1,76,82370
甘肃,2021,文科,3,72,82373
甘肃,2021,文科,1,71,82374
甘肃,2021,文科,2,67,82376
甘肃,2021,文科,1,66,82377
甘肃,2021,文科,1,64,82378
甘肃,2021,文科,1,62,82379
甘肃,2021,文科,2,60,82381
甘肃,2021,文科,1,53,82382
甘肃,2021,文科,1,52,82383
甘肃,2021,文科,1,50,82384
甘肃,2021,文科,1,49,82385
甘肃,2021,文科,1,44,82386
甘肃,2021,文科,1,42,82387
甘肃,2021,文科,2,39,82389
甘肃,2021,文科,2,31,82391
甘肃,2021,文科,2,29,82393
甘肃,2021,文科,1,26,82394
甘肃,2021,文科,1,25,82395
甘肃,2021,文科,1,24,82396
甘肃,2021,文科,1,22,82397
甘肃,2021,文科,1,20,82398
甘肃,2021,文科,1,17,82399
甘肃,2021,文科,1,16,82400
甘肃,2021,文科,1,15,82401
甘肃,2021,文科,1,14,82402
甘肃,2021,文科,2,13,82404
甘肃,2021,文科,1,12,82405
甘肃,2021,文科,1,9,82406
甘肃,2021,文科,1,4,82407
内蒙古,2021,理科,11,687,11
内蒙古,2021,理科,1,686,12
内蒙古,2021,理科,2,684,14
内蒙古,2021,理科,1,683,15
内蒙古,2021,理科,3,682,18
内蒙古,2021,理科,3,680,21
内蒙古,2021,理科,4,679,25
内蒙古,2021,理科,2,678,27
内蒙古,2021,理科,5,677,32
内蒙古,2021,理科,3,676,35
内蒙古,2021,理科,4,675,39
内蒙古,2021,理科,1,674,40
内蒙古,2021,理科,3,673,43
内蒙古,2021,理科,5,672,48
内蒙古,2021,理科,5,671,53
内蒙古,2021,理科,7,670,60
内蒙古,2021,理科,4,669,64
内蒙古,2021,理科,7,668,71
内蒙古,2021,理科,7,667,78
内蒙古,2021,理科,6,666,84
内蒙古,2021,理科,6,665,90
内蒙古,2021,理科,4,664,94
内蒙古,2021,理科,5,663,99
内蒙古,2021,理科,6,662,105
内蒙古,2021,理科,8,661,113
内蒙古,2021,理科,4,660,117
内蒙古,2021,理科,12,659,129
内蒙古,2021,理科,9,658,138
内蒙古,2021,理科,11,657,149
内蒙古,2021,理科,10,656,159
内蒙古,2021,理科,7,655,166
内蒙古,2021,理科,9,654,175
内蒙古,2021,理科,13,653,188
内蒙古,2021,理科,9,652,197
内蒙古,2021,理科,10,651,207
内蒙古,2021,理科,16,650,223
内蒙古,2021,理科,13,649,236
内蒙古,2021,理科,21,648,257
内蒙古,2021,理科,12,647,269
内蒙古,2021,理科,17,646,286
内蒙古,2021,理科,13,645,299
内蒙古,2021,理科,20,644,319
内蒙古,2021,理科,25,643,344
内蒙古,2021,理科,14,642,358
内蒙古,2021,理科,23,641,381
内蒙古,2021,理科,14,640,395
内蒙古,2021,理科,23,639,418
内蒙古,2021,理科,22,638,440
内蒙古,2021,理科,14,637,454
内蒙古,2021,理科,23,636,477
内蒙古,2021,理科,40,635,517
内蒙古,2021,理科,32,634,549
内蒙古,2021,理科,22,633,571
内蒙古,2021,理科,31,632,602
内蒙古,2021,理科,28,631,630
内蒙古,2021,理科,31,630,661
内蒙古,2021,理科,33,629,694
内蒙古,2021,理科,36,628,730
内蒙古,2021,理科,30,627,760
内蒙古,2021,理科,33,626,793
内蒙古,2021,理科,34,625,827
内蒙古,2021,理科,38,624,865
内蒙古,2021,理科,23,623,888
内蒙古,2021,理科,39,622,927
内蒙古,2021,理科,42,621,969
内蒙古,2021,理科,55,620,1024
内蒙古,2021,理科,32,619,1056
内蒙古,2021,理科,37,618,1093
内蒙古,2021,理科,33,617,1126
内蒙古,2021,理科,45,616,1171
内蒙古,2021,理科,35,615,1206
内蒙古,2021,理科,35,614,1241
内蒙古,2021,理科,45,613,1286
内蒙古,2021,理科,41,612,1327
内蒙古,2021,理科,41,611,1368
内蒙古,2021,理科,36,610,1404
内蒙古,2021,理科,49,609,1453
内蒙古,2021,理科,47,608,1500
内蒙古,2021,理科,48,607,1548
内蒙古,2021,理科,41,606,1589
内蒙古,2021,理科,48,605,1637
内蒙古,2021,理科,61,604,1698
内蒙古,2021,理科,51,603,1749
内蒙古,2021,理科,61,602,1810
内蒙古,2021,理科,58,601,1868
内蒙古,2021,理科,55,600,1923
内蒙古,2021,理科,58,599,1981
内蒙古,2021,理科,52,598,2033
内蒙古,2021,理科,62,597,2095
内蒙古,2021,理科,63,596,2158
内蒙古,2021,理科,62,595,2220
内蒙古,2021,理科,71,594,2291
内蒙古,2021,理科,53,593,2344
内蒙古,2021,理科,74,592,2418
内蒙古,2021,理科,78,591,2496
内蒙古,2021,理科,80,590,2576
内蒙古,2021,理科,65,589,2641
内蒙古,2021,理科,75,588,2716
内蒙古,2021,理科,70,587,2786
内蒙古,2021,理科,72,586,2858
内蒙古,2021,理科,77,585,2935
内蒙古,2021,理科,68,584,3003
内蒙古,2021,理科,85,583,3088
内蒙古,2021,理科,93,582,3181
内蒙古,2021,理科,79,581,3260
内蒙古,2021,理科,78,580,3338
内蒙古,2021,理科,87,579,3425
内蒙古,2021,理科,78,578,3503
内蒙古,2021,理科,83,577,3586
内蒙古,2021,理科,90,576,3676
内蒙古,2021,理科,90,575,3766
内蒙古,2021,理科,121,574,3887
内蒙古,2021,理科,109,573,3996
内蒙古,2021,理科,92,572,4088
内蒙古,2021,理科,103,571,4191
内蒙古,2021,理科,97,570,4288
内蒙古,2021,理科,85,569,4373
内蒙古,2021,理科,96,568,4469
内蒙古,2021,理科,100,567,4569
内蒙古,2021,理科,100,566,4669
内蒙古,2021,理科,92,565,4761
内蒙古,2021,理科,92,564,4853
内蒙古,2021,理科,102,563,4955
内蒙古,2021,理科,110,562,5065
内蒙古,2021,理科,113,561,5178
内蒙古,2021,理科,99,560,5277
内蒙古,2021,理科,108,559,5385
内蒙古,2021,理科,108,558,5493
内蒙古,2021,理科,122,557,5615
内蒙古,2021,理科,102,556,5717
内蒙古,2021,理科,113,555,5830
内蒙古,2021,理科,119,554,5949
内蒙古,2021,理科,127,553,6076
内蒙古,2021,理科,108,552,6184
内蒙古,2021,理科,120,551,6304
内蒙古,2021,理科,114,550,6418
内蒙古,2021,理科,120,549,6538
内蒙古,2021,理科,125,548,6663
内蒙古,2021,理科,124,547,6787
内蒙古,2021,理科,106,546,6893
内蒙古,2021,理科,118,545,7011
内蒙古,2021,理科,125,544,7136
内蒙古,2021,理科,125,543,7261
内蒙古,2021,理科,136,542,7397
内蒙古,2021,理科,125,541,7522
内蒙古,2021,理科,141,540,7663
内蒙古,2021,理科,148,539,7811
内蒙古,2021,理科,124,538,7935
内蒙古,2021,理科,136,537,8071
内蒙古,2021,理科,161,536,8232
内蒙古,2021,理科,144,535,8376
内蒙古,2021,理科,130,534,8506
内蒙古,2021,理科,139,533,8645
内蒙古,2021,理科,131,532,8776
内蒙古,2021,理科,147,531,8923
内蒙古,2021,理科,148,530,9071
内蒙古,2021,理科,125,529,9196
内蒙古,2021,理科,134,528,9330
内蒙古,2021,理科,120,527,9450
内蒙古,2021,理科,147,526,9597
内蒙古,2021,理科,177,525,9774
内蒙古,2021,理科,140,524,9914
内蒙古,2021,理科,149,523,10063
内蒙古,2021,理科,134,522,10197
内蒙古,2021,理科,158,521,10355
内蒙古,2021,理科,148,520,10503
内蒙古,2021,理科,153,519,10656
内蒙古,2021,理科,146,518,10802
内蒙古,2021,理科,165,517,10967
内蒙古,2021,理科,138,516,11105
内蒙古,2021,理科,159,515,11264
内蒙古,2021,理科,163,514,11427
内蒙古,2021,理科,176,513,11603
内蒙古,2021,理科,172,512,11775
内蒙古,2021,理科,154,511,11929
内蒙古,2021,理科,164,510,12093
内蒙古,2021,理科,171,509,12264
内蒙古,2021,理科,152,508,12416
内蒙古,2021,理科,152,507,12568
内蒙古,2021,理科,157,506,12725
内蒙古,2021,理科,173,505,12898
内蒙古,2021,理科,188,504,13086
内蒙古,2021,理科,159,503,13245
内蒙古,2021,理科,179,502,13424
内蒙古,2021,理科,148,501,13572
内蒙古,2021,理科,181,500,13753
内蒙古,2021,理科,191,499,13944
内蒙古,2021,理科,156,498,14100
内蒙古,2021,理科,172,497,14272
内蒙古,2021,理科,164,496,14436
内蒙古,2021,理科,172,495,14608
内蒙古,2021,理科,183,494,14791
内蒙古,2021,理科,164,493,14955
内蒙古,2021,理科,179,492,15134
内蒙古,2021,理科,158,491,15292
内蒙古,2021,理科,167,490,15459
内蒙古,2021,理科,181,489,15640
内蒙古,2021,理科,182,488,15822
内蒙古,2021,理科,176,487,15998
内蒙古,2021,理科,182,486,16180
内蒙古,2021,理科,170,485,16350
内蒙古,2021,理科,199,484,16549
内蒙古,2021,理科,193,483,16742
内蒙古,2021,理科,177,482,16919
内蒙古,2021,理科,213,481,17132
内蒙古,2021,理科,159,480,17291
内蒙古,2021,理科,180,479,17471
内蒙古,2021,理科,203,478,17674
内蒙古,2021,理科,177,477,17851
内蒙古,2021,理科,193,476,18044
内蒙古,2021,理科,170,475,18214
内蒙古,2021,理科,178,474,18392
内蒙古,2021,理科,202,473,18594
内蒙古,2021,理科,175,472,18769
内蒙古,2021,理科,198,471,18967
内蒙古,2021,理科,234,470,19201
内蒙古,2021,理科,192,469,19393
内蒙古,2021,理科,197,468,19590
内蒙古,2021,理科,198,467,19788
内蒙古,2021,理科,210,466,19998
内蒙古,2021,理科,196,465,20194
内蒙古,2021,理科,202,464,20396
内蒙古,2021,理科,200,463,20596
内蒙古,2021,理科,213,462,20809
内蒙古,2021,理科,215,461,21024
内蒙古,2021,理科,203,460,21227
内蒙古,2021,理科,234,459,21461
内蒙古,2021,理科,237,458,21698
内蒙古,2021,理科,207,457,21905
内蒙古,2021,理科,210,456,22115
内蒙古,2021,理科,191,455,22306
内蒙古,2021,理科,214,454,22520
内蒙古,2021,理科,209,453,22729
内蒙古,2021,理科,214,452,22943
内蒙古,2021,理科,208,451,23151
内蒙古,2021,理科,206,450,23357
内蒙古,2021,理科,198,449,23555
内蒙古,2021,理科,228,448,23783
内蒙古,2021,理科,196,447,23979
内蒙古,2021,理科,191,446,24170
内蒙古,2021,理科,206,445,24376
内蒙古,2021,理科,224,444,24600
内蒙古,2021,理科,200,443,24800
内蒙古,2021,理科,215,442,25015
内蒙古,2021,理科,214,441,25229
内蒙古,2021,理科,212,440,25441
内蒙古,2021,理科,211,439,25652
内蒙古,2021,理科,219,438,25871
内蒙古,2021,理科,200,437,26071
内蒙古,2021,理科,238,436,26309
内蒙古,2021,理科,209,435,26518
内蒙古,2021,理科,222,434,26740
内蒙古,2021,理科,223,433,26963
内蒙古,2021,理科,238,432,27201
内蒙古,2021,理科,226,431,27427
内蒙古,2021,理科,204,430,27631
内蒙古,2021,理科,220,429,27851
内蒙古,2021,理科,225,428,28076
内蒙古,2021,理科,221,427,28297
内蒙古,2021,理科,215,426,28512
内蒙古,2021,理科,220,425,28732
内蒙古,2021,理科,254,424,28986
内蒙古,2021,理科,228,423,29214
内蒙古,2021,理科,249,422,29463
内蒙古,2021,理科,217,421,29680
内蒙古,2021,理科,211,420,29891
内蒙古,2021,理科,215,419,30106
内蒙古,2021,理科,243,418,30349
内蒙古,2021,理科,234,417,30583
内蒙古,2021,理科,262,416,30845
内蒙古,2021,理科,223,415,31068
内蒙古,2021,理科,217,414,31285
内蒙古,2021,理科,230,413,31515
内蒙古,2021,理科,238,412,31753
内蒙古,2021,理科,235,411,31988
内蒙古,2021,理科,213,410,32201
内蒙古,2021,理科,224,409,32425
内蒙古,2021,理科,219,408,32644
内蒙古,2021,理科,256,407,32900
内蒙古,2021,理科,242,406,33142
内蒙古,2021,理科,214,405,33356
内蒙古,2021,理科,228,404,33584
内蒙古,2021,理科,236,403,33820
内蒙古,2021,理科,237,402,34057
内蒙古,2021,理科,245,401,34302
内蒙古,2021,理科,222,400,34524
内蒙古,2021,理科,250,399,34774
内蒙古,2021,理科,224,398,34998
内蒙古,2021,理科,243,397,35241
内蒙古,2021,理科,233,396,35474
内蒙古,2021,理科,241,395,35715
内蒙古,2021,理科,242,394,35957
内蒙古,2021,理科,255,393,36212
内蒙古,2021,理科,253,392,36465
内蒙古,2021,理科,238,391,36703
内蒙古,2021,理科,235,390,36938
内蒙古,2021,理科,233,389,37171
内蒙古,2021,理科,262,388,37433
内蒙古,2021,理科,213,387,37646
内蒙古,2021,理科,259,386,37905
内蒙古,2021,理科,230,385,38135
内蒙古,2021,理科,225,384,38360
内蒙古,2021,理科,243,383,38603
内蒙古,2021,理科,235,382,38838
内蒙古,2021,理科,257,381,39095
内蒙古,2021,理科,248,380,39343
内蒙古,2021,理科,253,379,39596
内蒙古,2021,理科,259,378,39855
内蒙古,2021,理科,260,377,40115
内蒙古,2021,理科,266,376,40381
内蒙古,2021,理科,263,375,40644
内蒙古,2021,理科,269,374,40913
内蒙古,2021,理科,233,373,41146
内蒙古,2021,理科,232,372,41378
内蒙古,2021,理科,248,371,41626
内蒙古,2021,理科,263,370,41889
内蒙古,2021,理科,234,369,42123
内蒙古,2021,理科,230,368,42353
内蒙古,2021,理科,249,367,42602
内蒙古,2021,理科,272,366,42874
内蒙古,2021,理科,243,365,43117
内蒙古,2021,理科,278,364,43395
内蒙古,2021,理科,254,363,43649
内蒙古,2021,理科,239,362,43888
内蒙古,2021,理科,298,361,44186
内蒙古,2021,理科,246,360,44432
内蒙古,2021,理科,247,359,44679
内蒙古,2021,理科,292,358,44971
内蒙古,2021,理科,279,357,45250
内蒙古,2021,理科,243,356,45493
内蒙古,2021,理科,226,355,45719
内蒙古,2021,理科,261,354,45980
内蒙古,2021,理科,237,353,46217
内蒙古,2021,理科,230,352,46447
内蒙古,2021,理科,254,351,46701
内蒙古,2021,理科,257,350,46958
内蒙古,2021,理科,253,349,47211
内蒙古,2021,理科,234,348,47445
内蒙古,2021,理科,246,347,47691
内蒙古,2021,理科,222,346,47913
内蒙古,2021,理科,251,345,48164
内蒙古,2021,理科,266,344,48430
内蒙古,2021,理科,251,343,48681
内蒙古,2021,理科,207,342,48888
内蒙古,2021,理科,227,341,49115
内蒙古,2021,理科,247,340,49362
内蒙古,2021,理科,268,339,49630
内蒙古,2021,理科,236,338,49866
内蒙古,2021,理科,243,337,50109
内蒙古,2021,理科,254,336,50363
内蒙古,2021,理科,239,335,50602
内蒙古,2021,理科,247,334,50849
内蒙古,2021,理科,248,333,51097
内蒙古,2021,理科,225,332,51322
内蒙古,2021,理科,219,331,51541
内蒙古,2021,理科,242,330,51783
内蒙古,2021,理科,223,329,52006
内蒙古,2021,理科,194,328,52200
内蒙古,2021,理科,224,327,52424
内蒙古,2021,理科,229,326,52653
内蒙古,2021,理科,212,325,52865
内蒙古,2021,理科,223,324,53088
内蒙古,2021,理科,246,323,53334
内蒙古,2021,理科,228,322,53562
内蒙古,2021,理科,255,321,53817
内蒙古,2021,理科,234,320,54051
内蒙古,2021,理科,224,319,54275
内蒙古,2021,理科,207,318,54482
内蒙古,2021,理科,217,317,54699
内蒙古,2021,理科,204,316,54903
内蒙古,2021,理科,221,315,55124
内蒙古,2021,理科,223,314,55347
内蒙古,2021,理科,213,313,55560
内蒙古,2021,理科,209,312,55769
内蒙古,2021,理科,248,311,56017
内蒙古,2021,理科,200,310,56217
内蒙古,2021,理科,209,309,56426
内蒙古,2021,理科,205,308,56631
内蒙古,2021,理科,197,307,56828
内蒙古,2021,理科,208,306,57036
内蒙古,2021,理科,219,305,57255
内蒙古,2021,理科,186,304,57441
内蒙古,2021,理科,182,303,57623
内蒙古,2021,理科,190,302,57813
内蒙古,2021,理科,196,301,58009
内蒙古,2021,理科,218,300,58227
内蒙古,2021,理科,201,299,58428
内蒙古,2021,理科,201,298,58629
内蒙古,2021,理科,191,297,58820
内蒙古,2021,理科,208,296,59028
内蒙古,2021,理科,197,295,59225
内蒙古,2021,理科,217,294,59442
内蒙古,2021,理科,188,293,59630
内蒙古,2021,理科,187,292,59817
内蒙古,2021,理科,191,291,60008
内蒙古,2021,理科,202,290,60210
内蒙古,2021,理科,189,289,60399
内蒙古,2021,理科,188,288,60587
内蒙古,2021,理科,172,287,60759
内蒙古,2021,理科,201,286,60960
内蒙古,2021,理科,198,285,61158
内蒙古,2021,理科,178,284,61336
内蒙古,2021,理科,175,283,61511
内蒙古,2021,理科,165,282,61676
内蒙古,2021,理科,182,281,61858
内蒙古,2021,理科,166,280,62024
内蒙古,2021,理科,190,279,62214
内蒙古,2021,理科,180,278,62394
内蒙古,2021,理科,182,277,62576
内蒙古,2021,理科,157,276,62733
内蒙古,2021,理科,155,275,62888
内蒙古,2021,理科,163,274,63051
内蒙古,2021,理科,171,273,63222
内蒙古,2021,理科,143,272,63365
内蒙古,2021,理科,160,271,63525
内蒙古,2021,理科,164,270,63689
内蒙古,2021,理科,183,269,63872
内蒙古,2021,理科,150,268,64022
内蒙古,2021,理科,159,267,64181
内蒙古,2021,理科,162,266,64343
内蒙古,2021,理科,142,265,64485
内蒙古,2021,理科,140,264,64625
内蒙古,2021,理科,157,263,64782
内蒙古,2021,理科,123,262,64905
内蒙古,2021,理科,143,261,65048
内蒙古,2021,理科,135,260,65183
内蒙古,2021,理科,118,259,65301
内蒙古,2021,理科,105,258,65406
内蒙古,2021,理科,131,257,65537
内蒙古,2021,理科,118,256,65655
内蒙古,2021,理科,126,255,65781
内蒙古,2021,理科,134,254,65915
内蒙古,2021,理科,132,253,66047
内蒙古,2021,理科,125,252,66172
内蒙古,2021,理科,120,251,66292
内蒙古,2021,理科,123,250,66415
内蒙古,2021,理科,127,249,66542
内蒙古,2021,理科,129,248,66671
内蒙古,2021,理科,117,247,66788
内蒙古,2021,理科,138,246,66926
内蒙古,2021,理科,110,245,67036
内蒙古,2021,理科,120,244,67156
内蒙古,2021,理科,115,243,67271
内蒙古,2021,理科,138,242,67409
内蒙古,2021,理科,110,241,67519
内蒙古,2021,理科,122,240,67641
内蒙古,2021,理科,97,239,67738
内蒙古,2021,理科,116,238,67854
内蒙古,2021,理科,100,237,67954
内蒙古,2021,理科,91,236,68045
内蒙古,2021,理科,101,235,68146
内蒙古,2021,理科,102,234,68248
内蒙古,2021,理科,101,233,68349
内蒙古,2021,理科,94,232,68443
内蒙古,2021,理科,97,231,68540
内蒙古,2021,理科,101,230,68641
内蒙古,2021,理科,78,229,68719
内蒙古,2021,理科,91,228,68810
内蒙古,2021,理科,98,227,68908
内蒙古,2021,理科,88,226,68996
内蒙古,2021,理科,83,225,69079
内蒙古,2021,理科,91,224,69170
内蒙古,2021,理科,109,223,69279
内蒙古,2021,理科,76,222,69355
内蒙古,2021,理科,77,221,69432
内蒙古,2021,理科,87,220,69519
内蒙古,2021,理科,73,219,69592
内蒙古,2021,理科,77,218,69669
内蒙古,2021,理科,88,217,69757
内蒙古,2021,理科,85,216,69842
内蒙古,2021,理科,79,215,69921
内蒙古,2021,理科,60,214,69981
内蒙古,2021,理科,67,213,70048
内蒙古,2021,理科,63,212,70111
内蒙古,2021,理科,74,211,70185
内蒙古,2021,理科,56,210,70241
内蒙古,2021,理科,66,209,70307
内蒙古,2021,理科,75,208,70382
内蒙古,2021,理科,56,207,70438
内蒙古,2021,理科,66,206,70504
内蒙古,2021,理科,67,205,70571
内蒙古,2021,理科,50,204,70621
内蒙古,2021,理科,46,203,70667
内蒙古,2021,理科,54,202,70721
内蒙古,2021,理科,40,201,70761
内蒙古,2021,文科,12,653,12
内蒙古,2021,文科,1,651,13
内蒙古,2021,文科,2,650,15
内蒙古,2021,文科,3,649,18
内蒙古,2021,文科,1,648,19
内蒙古,2021,文科,1,647,20
内蒙古,2021,文科,3,646,23
内蒙古,2021,文科,2,645,25
内蒙古,2021,文科,2,644,27
内蒙古,2021,文科,3,643,30
内蒙古,2021,文科,4,642,34
内蒙古,2021,文科,3,641,37
内蒙古,2021,文科,4,640,41
内蒙古,2021,文科,5,639,46
内蒙古,2021,文科,3,638,49
内蒙古,2021,文科,5,637,54
内蒙古,2021,文科,4,636,58
内蒙古,2021,文科,6,635,64
内蒙古,2021,文科,6,634,70
内蒙古,2021,文科,6,633,76
内蒙古,2021,文科,8,632,84
内蒙古,2021,文科,3,631,87
内蒙古,2021,文科,5,630,92
内蒙古,2021,文科,4,629,96
内蒙古,2021,文科,11,628,107
内蒙古,2021,文科,8,627,115
内蒙古,2021,文科,5,626,120
内蒙古,2021,文科,10,625,130
内蒙古,2021,文科,6,624,136
内蒙古,2021,文科,6,623,142
内蒙古,2021,文科,14,622,156
内蒙古,2021,文科,10,621,166
内蒙古,2021,文科,8,620,174
内蒙古,2021,文科,6,619,180
内蒙古,2021,文科,9,618,189
内蒙古,2021,文科,16,617,205
内蒙古,2021,文科,9,616,214
内蒙古,2021,文科,16,615,230
内蒙古,2021,文科,13,614,243
内蒙古,2021,文科,9,613,252
内蒙古,2021,文科,10,612,262
内蒙古,2021,文科,12,611,274
内蒙古,2021,文科,17,610,291
内蒙古,2021,文科,16,609,307
内蒙古,2021,文科,11,608,318
内蒙古,2021,文科,9,607,327
内蒙古,2021,文科,20,606,347
内蒙古,2021,文科,12,605,359
内蒙古,2021,文科,26,604,385
内蒙古,2021,文科,23,603,408
内蒙古,2021,文科,11,602,419
内蒙古,2021,文科,28,601,447
内蒙古,2021,文科,20,600,467
内蒙古,2021,文科,21,599,488
内蒙古,2021,文科,27,598,515
内蒙古,2021,文科,26,597,541
内蒙古,2021,文科,22,596,563
内蒙古,2021,文科,31,595,594
内蒙古,2021,文科,22,594,616
内蒙古,2021,文科,15,593,631
内蒙古,2021,文科,21,592,652
内蒙古,2021,文科,30,591,682
内蒙古,2021,文科,30,590,712
内蒙古,2021,文科,29,589,741
内蒙古,2021,文科,40,588,781
内蒙古,2021,文科,29,587,810
内蒙古,2021,文科,23,586,833
内蒙古,2021,文科,31,585,864
内蒙古,2021,文科,29,584,893
内蒙古,2021,文科,39,583,932
内蒙古,2021,文科,32,582,964
内蒙古,2021,文科,39,581,1003
内蒙古,2021,文科,37,580,1040
内蒙古,2021,文科,40,579,1080
内蒙古,2021,文科,43,578,1123
内蒙古,2021,文科,29,577,1152
内蒙古,2021,文科,42,576,1194
内蒙古,2021,文科,38,575,1232
内蒙古,2021,文科,52,574,1284
内蒙古,2021,文科,39,573,1323
内蒙古,2021,文科,44,572,1367
内蒙古,2021,文科,34,571,1401
内蒙古,2021,文科,49,570,1450
内蒙古,2021,文科,47,569,1497
内蒙古,2021,文科,37,568,1534
内蒙古,2021,文科,47,567,1581
内蒙古,2021,文科,49,566,1630
内蒙古,2021,文科,51,565,1681
内蒙古,2021,文科,51,564,1732
内蒙古,2021,文科,42,563,1774
内蒙古,2021,文科,53,562,1827
内蒙古,2021,文科,50,561,1877
内蒙古,2021,文科,51,560,1928
内蒙古,2021,文科,47,559,1975
内蒙古,2021,文科,55,558,2030
内蒙古,2021,文科,58,557,2088
内蒙古,2021,文科,49,556,2137
内蒙古,2021,文科,49,555,2186
内蒙古,2021,文科,46,554,2232
内蒙古,2021,文科,65,553,2297
内蒙古,2021,文科,55,552,2352
内蒙古,2021,文科,58,551,2410
内蒙古,2021,文科,66,550,2476
内蒙古,2021,文科,42,549,2518
内蒙古,2021,文科,69,548,2587
内蒙古,2021,文科,59,547,2646
内蒙古,2021,文科,69,546,2715
内蒙古,2021,文科,63,545,2778
内蒙古,2021,文科,65,544,2843
内蒙古,2021,文科,53,543,2896
内蒙古,2021,文科,61,542,2957
内蒙古,2021,文科,78,541,3035
内蒙古,2021,文科,65,540,3100
内蒙古,2021,文科,74,539,3174
内蒙古,2021,文科,52,538,3226
内蒙古,2021,文科,65,537,3291
内蒙古,2021,文科,61,536,3352
内蒙古,2021,文科,75,535,3427
内蒙古,2021,文科,61,534,3488
内蒙古,2021,文科,81,533,3569
内蒙古,2021,文科,89,532,3658
内蒙古,2021,文科,81,531,3739
内蒙古,2021,文科,60,530,3799
内蒙古,2021,文科,70,529,3869
内蒙古,2021,文科,84,528,3953
内蒙古,2021,文科,77,527,4030
内蒙古,2021,文科,69,526,4099
内蒙古,2021,文科,64,525,4163
内蒙古,2021,文科,78,524,4241
内蒙古,2021,文科,67,523,4308
内蒙古,2021,文科,78,522,4386
内蒙古,2021,文科,76,521,4462
内蒙古,2021,文科,74,520,4536
内蒙古,2021,文科,89,519,4625
内蒙古,2021,文科,78,518,4703
内蒙古,2021,文科,95,517,4798
内蒙古,2021,文科,82,516,4880
内蒙古,2021,文科,97,515,4977
内蒙古,2021,文科,74,514,5051
内蒙古,2021,文科,85,513,5136
内蒙古,2021,文科,101,512,5237
内蒙古,2021,文科,97,511,5334
内蒙古,2021,文科,77,510,5411
内蒙古,2021,文科,108,509,5519
内蒙古,2021,文科,86,508,5605
内蒙古,2021,文科,105,507,5710
内蒙古,2021,文科,104,506,5814
内蒙古,2021,文科,85,505,5899
内蒙古,2021,文科,90,504,5989
内蒙古,2021,文科,84,503,6073
内蒙古,2021,文科,84,502,6157
内蒙古,2021,文科,114,501,6271
内蒙古,2021,文科,93,500,6364
内蒙古,2021,文科,117,499,6481
内蒙古,2021,文科,99,498,6580
内蒙古,2021,文科,87,497,6667
内蒙古,2021,文科,82,496,6749
内蒙古,2021,文科,106,495,6855
内蒙古,2021,文科,103,494,6958
内蒙古,2021,文科,103,493,7061
内蒙古,2021,文科,108,492,7169
内蒙古,2021,文科,110,491,7279
内蒙古,2021,文科,103,490,7382
内蒙古,2021,文科,90,489,7472
内蒙古,2021,文科,108,488,7580
内蒙古,2021,文科,103,487,7683
内蒙古,2021,文科,120,486,7803
内蒙古,2021,文科,125,485,7928
内蒙古,2021,文科,92,484,8020
内蒙古,2021,文科,88,483,8108
内蒙古,2021,文科,121,482,8229
内蒙古,2021,文科,88,481,8317
内蒙古,2021,文科,122,480,8439
内蒙古,2021,文科,108,479,8547
内蒙古,2021,文科,112,478,8659
内蒙古,2021,文科,108,477,8767
内蒙古,2021,文科,110,476,8877
内蒙古,2021,文科,91,475,8968
内蒙古,2021,文科,130,474,9098
内蒙古,2021,文科,131,473,9229
内蒙古,2021,文科,118,472,9347
内蒙古,2021,文科,123,471,9470
内蒙古,2021,文科,109,470,9579
内蒙古,2021,文科,111,469,9690
内蒙古,2021,文科,131,468,9821
内蒙古,2021,文科,146,467,9967
内蒙古,2021,文科,121,466,10088
内蒙古,2021,文科,113,465,10201
内蒙古,2021,文科,135,464,10336
内蒙古,2021,文科,121,463,10457
内蒙古,2021,文科,114,462,10571
内蒙古,2021,文科,133,461,10704
内蒙古,2021,文科,132,460,10836
内蒙古,2021,文科,149,459,10985
内蒙古,2021,文科,150,458,11135
内蒙古,2021,文科,150,457,11285
内蒙古,2021,文科,120,456,11405
内蒙古,2021,文科,112,455,11517
内蒙古,2021,文科,121,454,11638
内蒙古,2021,文科,120,453,11758
内蒙古,2021,文科,120,452,11878
内蒙古,2021,文科,133,451,12011
内蒙古,2021,文科,133,450,12144
内蒙古,2021,文科,138,449,12282
内蒙古,2021,文科,131,448,12413
内蒙古,2021,文科,132,447,12545
内蒙古,2021,文科,152,446,12697
内蒙古,2021,文科,126,445,12823
内蒙古,2021,文科,111,444,12934
内蒙古,2021,文科,153,443,13087
内蒙古,2021,文科,146,442,13233
内蒙古,2021,文科,126,441,13359
内蒙古,2021,文科,122,440,13481
内蒙古,2021,文科,127,439,13608
内蒙古,2021,文科,131,438,13739
内蒙古,2021,文科,138,437,13877
内蒙古,2021,文科,145,436,14022
内蒙古,2021,文科,130,435,14152
内蒙古,2021,文科,129,434,14281
内蒙古,2021,文科,136,433,14417
内蒙古,2021,文科,158,432,14575
内蒙古,2021,文科,135,431,14710
内蒙古,2021,文科,121,430,14831
内蒙古,2021,文科,135,429,14966
内蒙古,2021,文科,128,428,15094
内蒙古,2021,文科,137,427,15231
内蒙古,2021,文科,148,426,15379
内蒙古,2021,文科,121,425,15500
内蒙古,2021,文科,127,424,15627
内蒙古,2021,文科,124,423,15751
内蒙古,2021,文科,108,422,15859
内蒙古,2021,文科,102,421,15961
内蒙古,2021,文科,113,420,16074
内蒙古,2021,文科,119,419,16193
内蒙古,2021,文科,141,418,16334
内蒙古,2021,文科,113,417,16447
内蒙古,2021,文科,126,416,16573
内蒙古,2021,文科,139,415,16712
内蒙古,2021,文科,132,414,16844
内蒙古,2021,文科,125,413,16969
内蒙古,2021,文科,117,412,17086
内蒙古,2021,文科,131,411,17217
内蒙古,2021,文科,136,410,17353
内蒙古,2021,文科,120,409,17473
内蒙古,2021,文科,134,408,17607
内蒙古,2021,文科,135,407,17742
内蒙古,2021,文科,126,406,17868
内蒙古,2021,文科,120,405,17988
内蒙古,2021,文科,133,404,18121
内蒙古,2021,文科,144,403,18265
内蒙古,2021,文科,108,402,18373
内蒙古,2021,文科,137,401,18510
内蒙古,2021,文科,119,400,18629
内蒙古,2021,文科,137,399,18766
内蒙古,2021,文科,139,398,18905
内蒙古,2021,文科,141,397,19046
内蒙古,2021,文科,116,396,19162
内蒙古,2021,文科,114,395,19276
内蒙古,2021,文科,126,394,19402
内蒙古,2021,文科,135,393,19537
内蒙古,2021,文科,114,392,19651
内蒙古,2021,文科,99,391,19750
内蒙古,2021,文科,118,390,19868
内蒙古,2021,文科,121,389,19989
内蒙古,2021,文科,123,388,20112
内蒙古,2021,文科,136,387,20248
内蒙古,2021,文科,128,386,20376
内蒙古,2021,文科,105,385,20481
内蒙古,2021,文科,148,384,20629
内蒙古,2021,文科,104,383,20733
内蒙古,2021,文科,110,382,20843
内蒙古,2021,文科,101,381,20944
内蒙古,2021,文科,98,380,21042
内蒙古,2021,文科,127,379,21169
内蒙古,2021,文科,105,378,21274
内蒙古,2021,文科,119,377,21393
内蒙古,2021,文科,120,376,21513
内蒙古,2021,文科,103,375,21616
内蒙古,2021,文科,119,374,21735
内蒙古,2021,文科,134,373,21869
内蒙古,2021,文科,124,372,21993
内蒙古,2021,文科,116,371,22109
内蒙古,2021,文科,114,370,22223
内蒙古,2021,文科,124,369,22347
内蒙古,2021,文科,122,368,22469
内蒙古,2021,文科,130,367,22599
内蒙古,2021,文科,96,366,22695
内蒙古,2021,文科,126,365,22821
内蒙古,2021,文科,118,364,22939
内蒙古,2021,文科,118,363,23057
内蒙古,2021,文科,97,362,23154
内蒙古,2021,文科,111,361,23265
内蒙古,2021,文科,113,360,23378
内蒙古,2021,文科,102,359,23480
内蒙古,2021,文科,111,358,23591
内蒙古,2021,文科,107,357,23698
内蒙古,2021,文科,112,356,23810
内蒙古,2021,文科,106,355,23916
内蒙古,2021,文科,119,354,24035
内蒙古,2021,文科,106,353,24141
内蒙古,2021,文科,95,352,24236
内蒙古,2021,文科,125,351,24361
内蒙古,2021,文科,92,350,24453
内蒙古,2021,文科,113,349,24566
内蒙古,2021,文科,92,348,24658
内蒙古,2021,文科,124,347,24782
内蒙古,2021,文科,109,346,24891
内蒙古,2021,文科,101,345,24992
内蒙古,2021,文科,89,344,25081
内蒙古,2021,文科,104,343,25185
内蒙古,2021,文科,85,342,25270
内蒙古,2021,文科,115,341,25385
内蒙古,2021,文科,110,340,25495
内蒙古,2021,文科,100,339,25595
内蒙古,2021,文科,97,338,25692
内蒙古,2021,文科,108,337,25800
内蒙古,2021,文科,105,336,25905
内蒙古,2021,文科,91,335,25996
内蒙古,2021,文科,124,334,26120
内蒙古,2021,文科,97,333,26217
内蒙古,2021,文科,105,332,26322
内蒙古,2021,文科,102,331,26424
内蒙古,2021,文科,94,330,26518
内蒙古,2021,文科,90,329,26608
内蒙古,2021,文科,100,328,26708
内蒙古,2021,文科,95,327,26803
内蒙古,2021,文科,91,326,26894
内蒙古,2021,文科,106,325,27000
内蒙古,2021,文科,109,324,27109
内蒙古,2021,文科,90,323,27199
内蒙古,2021,文科,92,322,27291
内蒙古,2021,文科,100,321,27391
内蒙古,2021,文科,76,320,27467
内蒙古,2021,文科,103,319,27570
内蒙古,2021,文科,105,318,27675
内蒙古,2021,文科,75,317,27750
内蒙古,2021,文科,91,316,27841
内蒙古,2021,文科,94,315,27935
内蒙古,2021,文科,80,314,28015
内蒙古,2021,文科,72,313,28087
内蒙古,2021,文科,81,312,28168
内蒙古,2021,文科,88,311,28256
内蒙古,2021,文科,83,310,28339
内蒙古,2021,文科,77,309,28416
内蒙古,2021,文科,97,308,28513
内蒙古,2021,文科,82,307,28595
内蒙古,2021,文科,86,306,28681
内蒙古,2021,文科,92,305,28773
内蒙古,2021,文科,87,304,28860
内蒙古,2021,文科,80,303,28940
内蒙古,2021,文科,82,302,29022
内蒙古,2021,文科,74,301,29096
内蒙古,2021,文科,77,300,29173
内蒙古,2021,文科,71,299,29244
内蒙古,2021,文科,73,298,29317
内蒙古,2021,文科,75,297,29392
内蒙古,2021,文科,81,296,29473
内蒙古,2021,文科,87,295,29560
内蒙古,2021,文科,75,294,29635
内蒙古,2021,文科,62,293,29697
内蒙古,2021,文科,78,292,29775
内蒙古,2021,文科,73,291,29848
内蒙古,2021,文科,71,290,29919
内蒙古,2021,文科,77,289,29996
内蒙古,2021,文科,76,288,30072
内蒙古,2021,文科,68,287,30140
内蒙古,2021,文科,74,286,30214
内蒙古,2021,文科,78,285,30292
内蒙古,2021,文科,72,284,30364
内蒙古,2021,文科,61,283,30425
内蒙古,2021,文科,70,282,30495
内蒙古,2021,文科,67,281,30562
内蒙古,2021,文科,55,280,30617
内蒙古,2021,文科,69,279,30686
内蒙古,2021,文科,68,278,30754
内蒙古,2021,文科,70,277,30824
内蒙古,2021,文科,59,276,30883
内蒙古,2021,文科,57,275,30940
内蒙古,2021,文科,50,274,30990
内蒙古,2021,文科,60,273,31050
内蒙古,2021,文科,60,272,31110
内蒙古,2021,文科,51,271,31161
内蒙古,2021,文科,52,270,31213
内蒙古,2021,文科,47,269,31260
内蒙古,2021,文科,58,268,31318
内蒙古,2021,文科,48,267,31366
内蒙古,2021,文科,59,266,31425
内蒙古,2021,文科,46,265,31471
内蒙古,2021,文科,60,264,31531
内蒙古,2021,文科,62,263,31593
内蒙古,2021,文科,43,262,31636
内蒙古,2021,文科,57,261,31693
内蒙古,2021,文科,66,260,31759
内蒙古,2021,文科,63,259,31822
内蒙古,2021,文科,44,258,31866
内蒙古,2021,文科,55,257,31921
内蒙古,2021,文科,41,256,31962
内蒙古,2021,文科,48,255,32010
内蒙古,2021,文科,53,254,32063
内蒙古,2021,文科,44,253,32107
内蒙古,2021,文科,63,252,32170
内蒙古,2021,文科,47,251,32217
内蒙古,2021,文科,49,250,32266
内蒙古,2021,文科,46,249,32312
内蒙古,2021,文科,39,248,32351
内蒙古,2021,文科,50,247,32401
内蒙古,2021,文科,50,246,32451
内蒙古,2021,文科,38,245,32489
内蒙古,2021,文科,43,244,32532
内蒙古,2021,文科,36,243,32568
内蒙古,2021,文科,61,242,32629
内蒙古,2021,文科,37,241,32666
内蒙古,2021,文科,33,240,32699
内蒙古,2021,文科,36,239,32735
内蒙古,2021,文科,24,238,32759
内蒙古,2021,文科,24,237,32783
内蒙古,2021,文科,34,236,32817
内蒙古,2021,文科,28,235,32845
内蒙古,2021,文科,26,234,32871
内蒙古,2021,文科,38,233,32909
内蒙古,2021,文科,30,232,32939
内蒙古,2021,文科,29,231,32968
内蒙古,2021,文科,22,230,32990
内蒙古,2021,文科,35,229,33025
内蒙古,2021,文科,27,228,33052
内蒙古,2021,文科,27,227,33079
内蒙古,2021,文科,28,226,33107
内蒙古,2021,文科,35,225,33142
内蒙古,2021,文科,27,224,33169
内蒙古,2021,文科,30,223,33199
内蒙古,2021,文科,21,222,33220
内蒙古,2021,文科,18,221,33238
内蒙古,2021,文科,21,220,33259
内蒙古,2021,文科,24,219,33283
内蒙古,2021,文科,28,218,33311
内蒙古,2021,文科,25,217,33336
内蒙古,2021,文科,21,216,33357
内蒙古,2021,文科,16,215,33373
内蒙古,2021,文科,25,214,33398
内蒙古,2021,文科,18,213,33416
内蒙古,2021,文科,17,212,33433
内蒙古,2021,文科,17,211,33450
内蒙古,2021,文科,20,210,33470
内蒙古,2021,文科,15,209,33485
内蒙古,2021,文科,21,208,33506
内蒙古,2021,文科,23,207,33529
内蒙古,2021,文科,12,206,33541
内蒙古,2021,文科,12,205,33553
内蒙古,2021,文科,15,204,33568
内蒙古,2021,文科,15,203,33583
内蒙古,2021,文科,20,202,33603
内蒙古,2021,文科,9,201,33612
广西,2021,理科,10,696,10
广西,2021,理科,2,695,12
广西,2021,理科,3,694,15
广西,2021,理科,2,693,17
广西,2021,理科,3,692,20
广西,2021,理科,2,691,22
广西,2021,理科,2,689,24
广西,2021,理科,6,687,30
广西,2021,理科,1,686,31
广西,2021,理科,4,685,35
广西,2021,理科,5,684,40
广西,2021,理科,3,683,43
广西,2021,理科,5,682,48
广西,2021,理科,3,681,51
广西,2021,理科,4,680,55
广西,2021,理科,4,679,59
广西,2021,理科,2,678,61
广西,2021,理科,8,677,69
广西,2021,理科,3,676,72
广西,2021,理科,10,675,82
广西,2021,理科,11,674,93
广西,2021,理科,9,673,102
广西,2021,理科,8,672,110
广西,2021,理科,7,671,117
广西,2021,理科,8,670,125
广西,2021,理科,8,669,133
广西,2021,理科,11,668,144
广西,2021,理科,9,667,153
广西,2021,理科,12,666,165
广西,2021,理科,20,665,185
广西,2021,理科,15,664,200
广西,2021,理科,9,663,209
广西,2021,理科,14,662,223
广西,2021,理科,10,661,233
广西,2021,理科,16,660,249
广西,2021,理科,22,659,271
广西,2021,理科,31,658,302
广西,2021,理科,16,657,318
广西,2021,理科,26,656,344
广西,2021,理科,30,655,374
广西,2021,理科,25,654,399
广西,2021,理科,32,653,431
广西,2021,理科,25,652,456
广西,2021,理科,29,651,485
广西,2021,理科,34,650,519
广西,2021,理科,39,649,558
广西,2021,理科,31,648,589
广西,2021,理科,27,647,616
广西,2021,理科,29,646,645
广西,2021,理科,40,645,685
广西,2021,理科,39,644,724
广西,2021,理科,41,643,765
广西,2021,理科,31,642,796
广西,2021,理科,39,641,835
广西,2021,理科,43,640,878
广西,2021,理科,43,639,921
广西,2021,理科,45,638,966
广西,2021,理科,53,637,1019
广西,2021,理科,46,636,1065
广西,2021,理科,53,635,1118
广西,2021,理科,44,634,1162
广西,2021,理科,55,633,1217
广西,2021,理科,47,632,1264
广西,2021,理科,39,631,1303
广西,2021,理科,55,630,1358
广西,2021,理科,63,629,1421
广西,2021,理科,77,628,1498
广西,2021,理科,58,627,1556
广西,2021,理科,62,626,1618
广西,2021,理科,54,625,1672
广西,2021,理科,73,624,1745
广西,2021,理科,91,623,1836
广西,2021,理科,79,622,1915
广西,2021,理科,84,621,1999
广西,2021,理科,94,620,2093
广西,2021,理科,80,619,2173
广西,2021,理科,76,618,2249
广西,2021,理科,96,617,2345
广西,2021,理科,86,616,2431
广西,2021,理科,117,615,2548
广西,2021,理科,102,614,2650
广西,2021,理科,89,613,2739
广西,2021,理科,111,612,2850
广西,2021,理科,107,611,2957
广西,2021,理科,98,610,3055
广西,2021,理科,118,609,3173
广西,2021,理科,128,608,3301
广西,2021,理科,117,607,3418
广西,2021,理科,117,606,3535
广西,2021,理科,144,605,3679
广西,2021,理科,146,604,3825
广西,2021,理科,141,603,3966
广西,2021,理科,144,602,4110
广西,2021,理科,144,601,4254
广西,2021,理科,155,600,4409
广西,2021,理科,152,599,4561
广西,2021,理科,123,598,4684
广西,2021,理科,154,597,4838
广西,2021,理科,147,596,4985
广西,2021,理科,129,595,5114
广西,2021,理科,173,594,5287
广西,2021,理科,152,593,5439
广西,2021,理科,169,592,5608
广西,2021,理科,157,591,5765
广西,2021,理科,177,590,5942
广西,2021,理科,188,589,6130
广西,2021,理科,171,588,6301
广西,2021,理科,191,587,6492
广西,2021,理科,201,586,6693
广西,2021,理科,192,585,6885
广西,2021,理科,172,584,7057
广西,2021,理科,205,583,7262
广西,2021,理科,220,582,7482
广西,2021,理科,193,581,7675
广西,2021,理科,210,580,7885
广西,2021,理科,209,579,8094
广西,2021,理科,220,578,8314
广西,2021,理科,208,577,8522
广西,2021,理科,231,576,8753
广西,2021,理科,202,575,8955
广西,2021,理科,246,574,9201
广西,2021,理科,221,573,9422
广西,2021,理科,227,572,9649
广西,2021,理科,240,571,9889
广西,2021,理科,272,570,10161
广西,2021,理科,244,569,10405
广西,2021,理科,257,568,10662
广西,2021,理科,236,567,10898
广西,2021,理科,263,566,11161
广西,2021,理科,263,565,11424
广西,2021,理科,272,564,11696
广西,2021,理科,283,563,11979
广西,2021,理科,291,562,12270
广西,2021,理科,237,561,12507
广西,2021,理科,283,560,12790
广西,2021,理科,302,559,13092
广西,2021,理科,332,558,13424
广西,2021,理科,311,557,13735
广西,2021,理科,271,556,14006
广西,2021,理科,319,555,14325
广西,2021,理科,371,554,14696
广西,2021,理科,315,553,15011
广西,2021,理科,317,552,15328
广西,2021,理科,320,551,15648
广西,2021,理科,356,550,16004
广西,2021,理科,337,549,16341
广西,2021,理科,359,548,16700
广西,2021,理科,347,547,17047
广西,2021,理科,359,546,17406
广西,2021,理科,323,545,17729
广西,2021,理科,359,544,18088
广西,2021,理科,373,543,18461
广西,2021,理科,390,542,18851
广西,2021,理科,333,541,19184
广西,2021,理科,376,540,19560
广西,2021,理科,413,539,19973
广西,2021,理科,385,538,20358
广西,2021,理科,390,537,20748
广西,2021,理科,438,536,21186
广西,2021,理科,362,535,21548
广西,2021,理科,393,534,21941
广西,2021,理科,409,533,22350
广西,2021,理科,406,532,22756
广西,2021,理科,466,531,23222
广西,2021,理科,430,530,23652
广西,2021,理科,431,529,24083
广西,2021,理科,422,528,24505
广西,2021,理科,433,527,24938
广西,2021,理科,436,526,25374
广西,2021,理科,454,525,25828
广西,2021,理科,418,524,26246
广西,2021,理科,413,523,26659
广西,2021,理科,438,522,27097
广西,2021,理科,436,521,27533
广西,2021,理科,441,520,27974
广西,2021,理科,464,519,28438
广西,2021,理科,486,518,28924
广西,2021,理科,461,517,29385
广西,2021,理科,507,516,29892
广西,2021,理科,462,515,30354
广西,2021,理科,466,514,30820
广西,2021,理科,489,513,31309
广西,2021,理科,465,512,31774
广西,2021,理科,463,511,32237
广西,2021,理科,485,510,32722
广西,2021,理科,502,509,33224
广西,2021,理科,468,508,33692
广西,2021,理科,514,507,34206
广西,2021,理科,494,506,34700
广西,2021,理科,485,505,35185
广西,2021,理科,509,504,35694
广西,2021,理科,520,503,36214
广西,2021,理科,458,502,36672
广西,2021,理科,533,501,37205
广西,2021,理科,461,500,37666
广西,2021,理科,502,499,38168
广西,2021,理科,462,498,38630
广西,2021,理科,530,497,39160
广西,2021,理科,517,496,39677
广西,2021,理科,533,495,40210
广西,2021,理科,508,494,40718
广西,2021,理科,488,493,41206
广西,2021,理科,532,492,41738
广西,2021,理科,541,491,42279
广西,2021,理科,533,490,42812
广西,2021,理科,565,489,43377
广西,2021,理科,542,488,43919
广西,2021,理科,547,487,44466
广西,2021,理科,554,486,45020
广西,2021,理科,499,485,45519
广西,2021,理科,527,484,46046
广西,2021,理科,557,483,46603
广西,2021,理科,526,482,47129
广西,2021,理科,515,481,47644
广西,2021,理科,551,480,48195
广西,2021,理科,591,479,48786
广西,2021,理科,550,478,49336
广西,2021,理科,523,477,49859
广西,2021,理科,504,476,50363
广西,2021,理科,557,475,50920
广西,2021,理科,570,474,51490
广西,2021,理科,534,473,52024
广西,2021,理科,536,472,52560
广西,2021,理科,556,471,53116
广西,2021,理科,582,470,53698
广西,2021,理科,561,469,54259
广西,2021,理科,532,468,54791
广西,2021,理科,546,467,55337
广西,2021,理科,564,466,55901
广西,2021,理科,639,465,56540
广西,2021,理科,552,464,57092
广西,2021,理科,569,463,57661
广西,2021,理科,536,462,58197
广西,2021,理科,557,461,58754
广西,2021,理科,588,460,59342
广西,2021,理科,571,459,59913
广西,2021,理科,554,458,60467
广西,2021,理科,569,457,61036
广西,2021,理科,623,456,61659
广西,2021,理科,566,455,62225
广西,2021,理科,566,454,62791
广西,2021,理科,534,453,63325
广西,2021,理科,550,452,63875
广西,2021,理科,542,451,64417
广西,2021,理科,588,450,65005
广西,2021,理科,599,449,65604
广西,2021,理科,564,448,66168
广西,2021,理科,589,447,66757
广西,2021,理科,597,446,67354
广西,2021,理科,586,445,67940
广西,2021,理科,576,444,68516
广西,2021,理科,593,443,69109
广西,2021,理科,601,442,69710
广西,2021,理科,611,441,70321
广西,2021,理科,601,440,70922
广西,2021,理科,603,439,71525
广西,2021,理科,616,438,72141
广西,2021,理科,663,437,72804
广西,2021,理科,611,436,73415
广西,2021,理科,617,435,74032
广西,2021,理科,653,434,74685
广西,2021,理科,633,433,75318
广西,2021,理科,637,432,75955
广西,2021,理科,592,431,76547
广西,2021,理科,545,430,77092
广西,2021,理科,590,429,77682
广西,2021,理科,656,428,78338
广西,2021,理科,611,427,78949
广西,2021,理科,631,426,79580
广西,2021,理科,630,425,80210
广西,2021,理科,650,424,80860
广西,2021,理科,694,423,81554
广西,2021,理科,624,422,82178
广西,2021,理科,593,421,82771
广西,2021,理科,647,420,83418
广西,2021,理科,616,419,84034
广西,2021,理科,627,418,84661
广西,2021,理科,643,417,85304
广西,2021,理科,629,416,85933
广西,2021,理科,683,415,86616
广西,2021,理科,641,414,87257
广西,2021,理科,662,413,87919
广西,2021,理科,691,412,88610
广西,2021,理科,700,411,89310
广西,2021,理科,711,410,90021
广西,2021,理科,694,409,90715
广西,2021,理科,727,408,91442
广西,2021,理科,699,407,92141
广西,2021,理科,694,406,92835
广西,2021,理科,701,405,93536
广西,2021,理科,682,404,94218
广西,2021,理科,666,403,94884
广西,2021,理科,660,402,95544
广西,2021,理科,709,401,96253
广西,2021,理科,716,400,96969
广西,2021,理科,662,399,97631
广西,2021,理科,704,398,98335
广西,2021,理科,659,397,98994
广西,2021,理科,710,396,99704
广西,2021,理科,714,395,100418
广西,2021,理科,736,394,101154
广西,2021,理科,673,393,101827
广西,2021,理科,690,392,102517
广西,2021,理科,724,391,103241
广西,2021,理科,739,390,103980
广西,2021,理科,707,389,104687
广西,2021,理科,679,388,105366
广西,2021,理科,659,387,106025
广西,2021,理科,742,386,106767
广西,2021,理科,719,385,107486
广西,2021,理科,712,384,108198
广西,2021,理科,726,383,108924
广西,2021,理科,717,382,109641
广西,2021,理科,706,381,110347
广西,2021,理科,707,380,111054
广西,2021,理科,735,379,111789
广西,2021,理科,702,378,112491
广西,2021,理科,694,377,113185
广西,2021,理科,738,376,113923
广西,2021,理科,723,375,114646
广西,2021,理科,740,374,115386
广西,2021,理科,710,373,116096
广西,2021,理科,732,372,116828
广西,2021,理科,721,371,117549
广西,2021,理科,755,370,118304
广西,2021,理科,750,369,119054
广西,2021,理科,686,368,119740
广西,2021,理科,681,367,120421
广西,2021,理科,741,366,121162
广西,2021,理科,788,365,121950
广西,2021,理科,739,364,122689
广西,2021,理科,716,363,123405
广西,2021,理科,733,362,124138
广西,2021,理科,728,361,124866
广西,2021,理科,776,360,125642
广西,2021,理科,755,359,126397
广西,2021,理科,707,358,127104
广西,2021,理科,716,357,127820
广西,2021,理科,775,356,128595
广西,2021,理科,771,355,129366
广西,2021,理科,796,354,130162
广西,2021,理科,735,353,130897
广西,2021,理科,745,352,131642
广西,2021,理科,716,351,132358
广西,2021,理科,713,350,133071
广西,2021,理科,725,349,133796
广西,2021,理科,735,348,134531
广西,2021,理科,767,347,135298
广西,2021,理科,704,346,136002
广西,2021,理科,724,345,136726
广西,2021,理科,699,344,137425
广西,2021,理科,729,343,138154
广西,2021,理科,701,342,138855
广西,2021,理科,714,341,139569
广西,2021,理科,670,340,140239
广西,2021,理科,675,339,140914
广西,2021,理科,766,338,141680
广西,2021,理科,715,337,142395
广西,2021,理科,695,336,143090
广西,2021,理科,736,335,143826
广西,2021,理科,726,334,144552
广西,2021,理科,664,333,145216
广西,2021,理科,648,332,145864
广西,2021,理科,715,331,146579
广西,2021,理科,651,330,147230
广西,2021,理科,711,329,147941
广西,2021,理科,695,328,148636
广西,2021,理科,714,327,149350
广西,2021,理科,709,326,150059
广西,2021,理科,692,325,150751
广西,2021,理科,672,324,151423
广西,2021,理科,670,323,152093
广西,2021,理科,644,322,152737
广西,2021,理科,663,321,153400
广西,2021,理科,646,320,154046
广西,2021,理科,712,319,154758
广西,2021,理科,664,318,155422
广西,2021,理科,680,317,156102
广西,2021,理科,672,316,156774
广西,2021,理科,693,315,157467
广西,2021,理科,671,314,158138
广西,2021,理科,605,313,158743
广西,2021,理科,640,312,159383
广西,2021,理科,639,311,160022
广西,2021,理科,619,310,160641
广西,2021,理科,644,309,161285
广西,2021,理科,605,308,161890
广西,2021,理科,656,307,162546
广西,2021,理科,646,306,163192
广西,2021,理科,600,305,163792
广西,2021,理科,608,304,164400
广西,2021,理科,576,303,164976
广西,2021,理科,580,302,165556
广西,2021,理科,591,301,166147
广西,2021,理科,636,300,166783
广西,2021,理科,631,299,167414
广西,2021,理科,580,298,167994
广西,2021,理科,543,297,168537
广西,2021,理科,584,296,169121
广西,2021,理科,598,295,169719
广西,2021,理科,566,294,170285
广西,2021,理科,577,293,170862
广西,2021,理科,561,292,171423
广西,2021,理科,552,291,171975
广西,2021,理科,554,290,172529
广西,2021,理科,538,289,173067
广西,2021,理科,536,288,173603
广西,2021,理科,536,287,174139
广西,2021,理科,500,286,174639
广西,2021,理科,534,285,175173
广西,2021,理科,514,284,175687
广西,2021,理科,500,283,176187
广西,2021,理科,514,282,176701
广西,2021,理科,550,281,177251
广西,2021,理科,541,280,177792
广西,2021,理科,554,279,178346
广西,2021,理科,494,278,178840
广西,2021,理科,474,277,179314
广西,2021,理科,513,276,179827
广西,2021,理科,527,275,180354
广西,2021,理科,520,274,180874
广西,2021,理科,492,273,181366
广西,2021,理科,460,272,181826
广西,2021,理科,458,271,182284
广西,2021,理科,464,270,182748
广西,2021,理科,461,269,183209
广西,2021,理科,461,268,183670
广西,2021,理科,458,267,184128
广西,2021,理科,460,266,184588
广西,2021,理科,458,265,185046
广西,2021,理科,453,264,185499
广西,2021,理科,435,263,185934
广西,2021,理科,435,262,186369
广西,2021,理科,439,261,186808
广西,2021,理科,411,260,187219
广西,2021,理科,429,259,187648
广西,2021,理科,397,258,188045
广西,2021,理科,407,257,188452
广西,2021,理科,394,256,188846
广西,2021,理科,406,255,189252
广西,2021,理科,421,254,189673
广西,2021,理科,432,253,190105
广西,2021,理科,387,252,190492
广西,2021,理科,381,251,190873
广西,2021,理科,389,250,191262
广西,2021,理科,370,249,191632
广西,2021,理科,402,248,192034
广西,2021,理科,353,247,192387
广西,2021,理科,387,246,192774
广西,2021,理科,357,245,193131
广西,2021,理科,377,244,193508
广西,2021,理科,335,243,193843
广西,2021,理科,318,242,194161
广西,2021,理科,334,241,194495
广西,2021,理科,334,240,194829
广西,2021,理科,360,239,195189
广西,2021,理科,333,238,195522
广西,2021,理科,304,237,195826
广西,2021,理科,327,236,196153
广西,2021,理科,307,235,196460
广西,2021,理科,353,234,196813
广西,2021,理科,320,233,197133
广西,2021,理科,302,232,197435
广西,2021,理科,304,231,197739
广西,2021,理科,268,230,198007
广西,2021,理科,298,229,198305
广西,2021,理科,306,228,198611
广西,2021,理科,292,227,198903
广西,2021,理科,296,226,199199
广西,2021,理科,288,225,199487
广西,2021,理科,261,224,199748
广西,2021,理科,259,223,200007
广西,2021,理科,268,222,200275
广西,2021,理科,254,221,200529
广西,2021,理科,281,220,200810
广西,2021,理科,235,219,201045
广西,2021,理科,238,218,201283
广西,2021,理科,270,217,201553
广西,2021,理科,230,216,201783
广西,2021,理科,236,215,202019
广西,2021,理科,207,214,202226
广西,2021,理科,218,213,202444
广西,2021,理科,228,212,202672
广西,2021,理科,235,211,202907
广西,2021,理科,231,210,203138
广西,2021,理科,207,209,203345
广西,2021,理科,245,208,203590
广西,2021,理科,190,207,203780
广西,2021,理科,204,206,203984
广西,2021,理科,194,205,204178
广西,2021,理科,196,204,204374
广西,2021,理科,178,203,204552
广西,2021,理科,209,202,204761
广西,2021,理科,185,201,204946
广西,2021,理科,196,200,205142
广西,2021,理科,150,199,205292
广西,2021,理科,173,198,205465
广西,2021,理科,162,197,205627
广西,2021,理科,154,196,205781
广西,2021,理科,207,195,205988
广西,2021,理科,168,194,206156
广西,2021,理科,158,193,206314
广西,2021,理科,174,192,206488
广西,2021,理科,148,191,206636
广西,2021,理科,161,190,206797
广西,2021,理科,146,189,206943
广西,2021,理科,141,188,207084
广西,2021,理科,145,187,207229
广西,2021,理科,128,186,207357
广西,2021,理科,135,185,207492
广西,2021,理科,128,184,207620
广西,2021,理科,113,183,207733
广西,2021,理科,130,182,207863
广西,2021,理科,116,181,207979
广西,2021,理科,138,180,208117
广西,2021,文科,11,671,11
广西,2021,文科,1,670,12
广西,2021,文科,1,669,13
广西,2021,文科,1,668,14
广西,2021,文科,1,667,15
广西,2021,文科,2,666,17
广西,2021,文科,1,665,18
广西,2021,文科,4,664,22
广西,2021,文科,2,663,24
广西,2021,文科,3,662,27
广西,2021,文科,2,661,29
广西,2021,文科,2,660,31
广西,2021,文科,2,659,33
广西,2021,文科,3,657,36
广西,2021,文科,5,656,41
广西,2021,文科,5,655,46
广西,2021,文科,10,654,56
广西,2021,文科,3,653,59
广西,2021,文科,8,652,67
广西,2021,文科,11,651,78
广西,2021,文科,3,650,81
广西,2021,文科,3,649,84
广西,2021,文科,3,648,87
广西,2021,文科,13,647,100
广西,2021,文科,6,646,106
广西,2021,文科,9,645,115
广西,2021,文科,11,644,126
广西,2021,文科,15,643,141
广西,2021,文科,9,642,150
广西,2021,文科,11,641,161
广西,2021,文科,14,640,175
广西,2021,文科,13,639,188
广西,2021,文科,12,638,200
广西,2021,文科,3,637,203
广西,2021,文科,13,636,216
广西,2021,文科,14,635,230
广西,2021,文科,16,634,246
广西,2021,文科,24,633,270
广西,2021,文科,19,632,289
广西,2021,文科,17,631,306
广西,2021,文科,17,630,323
广西,2021,文科,25,629,348
广西,2021,文科,25,628,373
广西,2021,文科,12,627,385
广西,2021,文科,29,626,414
广西,2021,文科,28,625,442
广西,2021,文科,21,624,463
广西,2021,文科,23,623,486
广西,2021,文科,18,622,504
广西,2021,文科,27,621,531
广西,2021,文科,26,620,557
广西,2021,文科,32,619,589
广西,2021,文科,28,618,617
广西,2021,文科,27,617,644
广西,2021,文科,29,616,673
广西,2021,文科,36,615,709
广西,2021,文科,34,614,743
广西,2021,文科,27,613,770
广西,2021,文科,32,612,802
广西,2021,文科,41,611,843
广西,2021,文科,41,610,884
广西,2021,文科,36,609,920
广西,2021,文科,43,608,963
广西,2021,文科,39,607,1002
广西,2021,文科,47,606,1049
广西,2021,文科,44,605,1093
广西,2021,文科,56,604,1149
广西,2021,文科,55,603,1204
广西,2021,文科,49,602,1253
广西,2021,文科,57,601,1310
广西,2021,文科,55,600,1365
广西,2021,文科,55,599,1420
广西,2021,文科,66,598,1486
广西,2021,文科,61,597,1547
广西,2021,文科,60,596,1607
广西,2021,文科,49,595,1656
广西,2021,文科,64,594,1720
广西,2021,文科,59,593,1779
广西,2021,文科,68,592,1847
广西,2021,文科,68,591,1915
广西,2021,文科,69,590,1984
广西,2021,文科,75,589,2059
广西,2021,文科,77,588,2136
广西,2021,文科,95,587,2231
广西,2021,文科,79,586,2310
广西,2021,文科,83,585,2393
广西,2021,文科,67,584,2460
广西,2021,文科,104,583,2564
广西,2021,文科,83,582,2647
广西,2021,文科,86,581,2733
广西,2021,文科,84,580,2817
广西,2021,文科,108,579,2925
广西,2021,文科,104,578,3029
广西,2021,文科,107,577,3136
广西,2021,文科,94,576,3230
广西,2021,文科,104,575,3334
广西,2021,文科,98,574,3432
广西,2021,文科,94,573,3526
广西,2021,文科,95,572,3621
广西,2021,文科,105,571,3726
广西,2021,文科,102,570,3828
广西,2021,文科,131,569,3959
广西,2021,文科,111,568,4070
广西,2021,文科,121,567,4191
广西,2021,文科,108,566,4299
广西,2021,文科,131,565,4430
广西,2021,文科,115,564,4545
广西,2021,文科,128,563,4673
广西,2021,文科,150,562,4823
广西,2021,文科,145,561,4968
广西,2021,文科,133,560,5101
广西,2021,文科,123,559,5224
广西,2021,文科,134,558,5358
广西,2021,文科,133,557,5491
广西,2021,文科,129,556,5620
广西,2021,文科,138,555,5758
广西,2021,文科,153,554,5911
广西,2021,文科,151,553,6062
广西,2021,文科,163,552,6225
广西,2021,文科,173,551,6398
广西,2021,文科,175,550,6573
广西,2021,文科,161,549,6734
广西,2021,文科,180,548,6914
广西,2021,文科,167,547,7081
广西,2021,文科,167,546,7248
广西,2021,文科,165,545,7413
广西,2021,文科,173,544,7586
广西,2021,文科,166,543,7752
广西,2021,文科,184,542,7936
广西,2021,文科,188,541,8124
广西,2021,文科,181,540,8305
广西,2021,文科,170,539,8475
广西,2021,文科,186,538,8661
广西,2021,文科,190,537,8851
广西,2021,文科,184,536,9035
广西,2021,文科,180,535,9215
广西,2021,文科,221,534,9436
广西,2021,文科,201,533,9637
广西,2021,文科,182,532,9819
广西,2021,文科,226,531,10045
广西,2021,文科,200,530,10245
广西,2021,文科,211,529,10456
广西,2021,文科,222,528,10678
广西,2021,文科,226,527,10904
广西,2021,文科,222,526,11126
广西,2021,文科,236,525,11362
广西,2021,文科,189,524,11551
广西,2021,文科,232,523,11783
广西,2021,文科,214,522,11997
广西,2021,文科,220,521,12217
广西,2021,文科,218,520,12435
广西,2021,文科,238,519,12673
广西,2021,文科,255,518,12928
广西,2021,文科,240,517,13168
广西,2021,文科,216,516,13384
广西,2021,文科,239,515,13623
广西,2021,文科,237,514,13860
广西,2021,文科,255,513,14115
广西,2021,文科,274,512,14389
广西,2021,文科,256,511,14645
广西,2021,文科,267,510,14912
广西,2021,文科,272,509,15184
广西,2021,文科,240,508,15424
广西,2021,文科,249,507,15673
广西,2021,文科,263,506,15936
广西,2021,文科,244,505,16180
广西,2021,文科,292,504,16472
广西,2021,文科,289,503,16761
广西,2021,文科,261,502,17022
广西,2021,文科,268,501,17290
广西,2021,文科,268,500,17558
广西,2021,文科,284,499,17842
广西,2021,文科,254,498,18096
广西,2021,文科,321,497,18417
广西,2021,文科,293,496,18710
广西,2021,文科,275,495,18985
广西,2021,文科,251,494,19236
广西,2021,文科,260,493,19496
广西,2021,文科,303,492,19799
广西,2021,文科,335,491,20134
广西,2021,文科,316,490,20450
广西,2021,文科,303,489,20753
广西,2021,文科,315,488,21068
广西,2021,文科,315,487,21383
广西,2021,文科,303,486,21686
广西,2021,文科,296,485,21982
广西,2021,文科,319,484,22301
广西,2021,文科,327,483,22628
广西,2021,文科,328,482,22956
广西,2021,文科,331,481,23287
广西,2021,文科,300,480,23587
广西,2021,文科,299,479,23886
广西,2021,文科,323,478,24209
广西,2021,文科,351,477,24560
广西,2021,文科,380,476,24940
广西,2021,文科,327,475,25267
广西,2021,文科,332,474,25599
广西,2021,文科,333,473,25932
广西,2021,文科,360,472,26292
广西,2021,文科,377,471,26669
广西,2021,文科,373,470,27042
广西,2021,文科,384,469,27426
广西,2021,文科,410,468,27836
广西,2021,文科,348,467,28184
广西,2021,文科,365,466,28549
广西,2021,文科,394,465,28943
广西,2021,文科,360,464,29303
广西,2021,文科,366,463,29669
广西,2021,文科,380,462,30049
广西,2021,文科,378,461,30427
广西,2021,文科,379,460,30806
广西,2021,文科,370,459,31176
广西,2021,文科,392,458,31568
广西,2021,文科,363,457,31931
广西,2021,文科,361,456,32292
广西,2021,文科,374,455,32666
广西,2021,文科,361,454,33027
广西,2021,文科,402,453,33429
广西,2021,文科,408,452,33837
广西,2021,文科,399,451,34236
广西,2021,文科,373,450,34609
广西,2021,文科,415,449,35024
广西,2021,文科,406,448,35430
广西,2021,文科,412,447,35842
广西,2021,文科,404,446,36246
广西,2021,文科,405,445,36651
广西,2021,文科,415,444,37066
广西,2021,文科,427,443,37493
广西,2021,文科,428,442,37921
广西,2021,文科,418,441,38339
广西,2021,文科,410,440,38749
广西,2021,文科,431,439,39180
广西,2021,文科,407,438,39587
广西,2021,文科,451,437,40038
广西,2021,文科,405,436,40443
广西,2021,文科,402,435,40845
广西,2021,文科,439,434,41284
广西,2021,文科,471,433,41755
广西,2021,文科,428,432,42183
广西,2021,文科,464,431,42647
广西,2021,文科,463,430,43110
广西,2021,文科,451,429,43561
广西,2021,文科,450,428,44011
广西,2021,文科,459,427,44470
广西,2021,文科,474,426,44944
广西,2021,文科,425,425,45369
广西,2021,文科,456,424,45825
广西,2021,文科,435,423,46260
广西,2021,文科,459,422,46719
广西,2021,文科,444,421,47163
广西,2021,文科,467,420,47630
广西,2021,文科,479,419,48109
广西,2021,文科,460,418,48569
广西,2021,文科,476,417,49045
广西,2021,文科,466,416,49511
广西,2021,文科,468,415,49979
广西,2021,文科,453,414,50432
广西,2021,文科,468,413,50900
广西,2021,文科,487,412,51387
广西,2021,文科,473,411,51860
广西,2021,文科,455,410,52315
广西,2021,文科,463,409,52778
广西,2021,文科,478,408,53256
广西,2021,文科,498,407,53754
广西,2021,文科,483,406,54237
广西,2021,文科,507,405,54744
广西,2021,文科,471,404,55215
广西,2021,文科,538,403,55753
广西,2021,文科,465,402,56218
广西,2021,文科,503,401,56721
广西,2021,文科,469,400,57190
广西,2021,文科,494,399,57684
广西,2021,文科,538,398,58222
广西,2021,文科,549,397,58771
广西,2021,文科,504,396,59275
广西,2021,文科,487,395,59762
广西,2021,文科,472,394,60234
广西,2021,文科,509,393,60743
广西,2021,文科,483,392,61226
广西,2021,文科,532,391,61758
广西,2021,文科,468,390,62226
广西,2021,文科,520,389,62746
广西,2021,文科,497,388,63243
广西,2021,文科,492,387,63735
广西,2021,文科,508,386,64243
广西,2021,文科,521,385,64764
广西,2021,文科,528,384,65292
广西,2021,文科,512,383,65804
广西,2021,文科,541,382,66345
广西,2021,文科,470,381,66815
广西,2021,文科,498,380,67313
广西,2021,文科,525,379,67838
广西,2021,文科,516,378,68354
广西,2021,文科,526,377,68880
广西,2021,文科,519,376,69399
广西,2021,文科,526,375,69925
广西,2021,文科,501,374,70426
广西,2021,文科,573,373,70999
广西,2021,文科,502,372,71501
广西,2021,文科,518,371,72019
广西,2021,文科,548,370,72567
广西,2021,文科,524,369,73091
广西,2021,文科,497,368,73588
广西,2021,文科,591,367,74179
广西,2021,文科,530,366,74709
广西,2021,文科,570,365,75279
广西,2021,文科,499,364,75778
广西,2021,文科,562,363,76340
广西,2021,文科,503,362,76843
广西,2021,文科,507,361,77350
广西,2021,文科,527,360,77877
广西,2021,文科,501,359,78378
广西,2021,文科,541,358,78919
广西,2021,文科,538,357,79457
广西,2021,文科,548,356,80005
广西,2021,文科,524,355,80529
广西,2021,文科,517,354,81046
广西,2021,文科,541,353,81587
广西,2021,文科,517,352,82104
广西,2021,文科,527,351,82631
广西,2021,文科,541,350,83172
广西,2021,文科,579,349,83751
广西,2021,文科,528,348,84279
广西,2021,文科,571,347,84850
广西,2021,文科,534,346,85384
广西,2021,文科,531,345,85915
广西,2021,文科,542,344,86457
广西,2021,文科,526,343,86983
广西,2021,文科,503,342,87486
广西,2021,文科,535,341,88021
广西,2021,文科,504,340,88525
广西,2021,文科,528,339,89053
广西,2021,文科,528,338,89581
广西,2021,文科,562,337,90143
广西,2021,文科,523,336,90666
广西,2021,文科,557,335,91223
广西,2021,文科,547,334,91770
广西,2021,文科,528,333,92298
广西,2021,文科,535,332,92833
广西,2021,文科,512,331,93345
广西,2021,文科,541,330,93886
广西,2021,文科,516,329,94402
广西,2021,文科,506,328,94908
广西,2021,文科,518,327,95426
广西,2021,文科,505,326,95931
广西,2021,文科,491,325,96422
广西,2021,文科,471,324,96893
广西,2021,文科,526,323,97419
广西,2021,文科,516,322,97935
广西,2021,文科,483,321,98418
广西,2021,文科,495,320,98913
广西,2021,文科,511,319,99424
广西,2021,文科,504,318,99928
广西,2021,文科,518,317,100446
广西,2021,文科,502,316,100948
广西,2021,文科,489,315,101437
广西,2021,文科,462,314,101899
广西,2021,文科,470,313,102369
广西,2021,文科,444,312,102813
广西,2021,文科,476,311,103289
广西,2021,文科,467,310,103756
广西,2021,文科,419,309,104175
广西,2021,文科,465,308,104640
广西,2021,文科,426,307,105066
广西,2021,文科,450,306,105516
广西,2021,文科,438,305,105954
广西,2021,文科,443,304,106397
广西,2021,文科,459,303,106856
广西,2021,文科,447,302,107303
广西,2021,文科,419,301,107722
广西,2021,文科,420,300,108142
广西,2021,文科,365,299,108507
广西,2021,文科,468,298,108975
广西,2021,文科,449,297,109424
广西,2021,文科,425,296,109849
广西,2021,文科,444,295,110293
广西,2021,文科,476,294,110769
广西,2021,文科,412,293,111181
广西,2021,文科,386,292,111567
广西,2021,文科,403,291,111970
广西,2021,文科,419,290,112389
广西,2021,文科,409,289,112798
广西,2021,文科,352,288,113150
广西,2021,文科,373,287,113523
广西,2021,文科,386,286,113909
广西,2021,文科,358,285,114267
广西,2021,文科,384,284,114651
广西,2021,文科,368,283,115019
广西,2021,文科,318,282,115337
广西,2021,文科,351,281,115688
广西,2021,文科,350,280,116038
广西,2021,文科,343,279,116381
广西,2021,文科,375,278,116756
广西,2021,文科,318,277,117074
广西,2021,文科,352,276,117426
广西,2021,文科,299,275,117725
广西,2021,文科,294,274,118019
广西,2021,文科,300,273,118319
广西,2021,文科,307,272,118626
广西,2021,文科,358,271,118984
广西,2021,文科,319,270,119303
广西,2021,文科,281,269,119584
广西,2021,文科,314,268,119898
广西,2021,文科,291,267,120189
广西,2021,文科,280,266,120469
广西,2021,文科,280,265,120749
广西,2021,文科,261,264,121010
广西,2021,文科,265,263,121275
广西,2021,文科,287,262,121562
广西,2021,文科,272,261,121834
广西,2021,文科,254,260,122088
广西,2021,文科,274,259,122362
广西,2021,文科,234,258,122596
广西,2021,文科,262,257,122858
广西,2021,文科,238,256,123096
广西,2021,文科,224,255,123320
广西,2021,文科,246,254,123566
广西,2021,文科,230,253,123796
广西,2021,文科,240,252,124036
广西,2021,文科,222,251,124258
广西,2021,文科,205,250,124463
广西,2021,文科,218,249,124681
广西,2021,文科,244,248,124925
广西,2021,文科,228,247,125153
广西,2021,文科,228,246,125381
广西,2021,文科,218,245,125599
广西,2021,文科,241,244,125840
广西,2021,文科,187,243,126027
广西,2021,文科,189,242,126216
广西,2021,文科,204,241,126420
广西,2021,文科,171,240,126591
广西,2021,文科,186,239,126777
广西,2021,文科,179,238,126956
广西,2021,文科,173,237,127129
广西,2021,文科,166,236,127295
广西,2021,文科,165,235,127460
广西,2021,文科,159,234,127619
广西,2021,文科,141,233,127760
广西,2021,文科,143,232,127903
广西,2021,文科,146,231,128049
广西,2021,文科,160,230,128209
广西,2021,文科,143,229,128352
广西,2021,文科,138,228,128490
广西,2021,文科,120,227,128610
广西,2021,文科,124,226,128734
广西,2021,文科,141,225,128875
广西,2021,文科,117,224,128992
广西,2021,文科,135,223,129127
广西,2021,文科,133,222,129260
广西,2021,文科,127,221,129387
广西,2021,文科,112,220,129499
广西,2021,文科,120,219,129619
广西,2021,文科,110,218,129729
广西,2021,文科,115,217,129844
广西,2021,文科,110,216,129954
广西,2021,文科,111,215,130065
广西,2021,文科,105,214,130170
广西,2021,文科,97,213,130267
广西,2021,文科,81,212,130348
广西,2021,文科,92,211,130440
广西,2021,文科,94,210,130534
广西,2021,文科,96,209,130630
广西,2021,文科,65,208,130695
广西,2021,文科,80,207,130775
广西,2021,文科,81,206,130856
广西,2021,文科,61,205,130917
广西,2021,文科,93,204,131010
广西,2021,文科,74,203,131084
广西,2021,文科,67,202,131151
广西,2021,文科,73,201,131224
广西,2021,文科,76,200,131300
广西,2021,文科,65,199,131365
广西,2021,文科,52,198,131417
广西,2021,文科,61,197,131478
广西,2021,文科,75,196,131553
广西,2021,文科,51,195,131604
广西,2021,文科,58,194,131662
广西,2021,文科,52,193,131714
广西,2021,文科,56,192,131770
广西,2021,文科,56,191,131826
广西,2021,文科,51,190,131877
广西,2021,文科,55,189,131932
广西,2021,文科,49,188,131981
广西,2021,文科,53,187,132034
广西,2021,文科,50,186,132084
广西,2021,文科,54,185,132138
广西,2021,文科,31,184,132169
广西,2021,文科,31,183,132200
广西,2021,文科,32,182,132232
广西,2021,文科,43,181,132275
广西,2021,文科,51,180,132326
宁夏,2021,理科,64,630,64
宁夏,2021,理科,8,629,72
宁夏,2021,理科,4,628,76
宁夏,2021,理科,1,627,77
宁夏,2021,理科,4,626,81
宁夏,2021,理科,5,625,86
宁夏,2021,理科,2,624,88
宁夏,2021,理科,3,623,91
宁夏,2021,理科,5,622,96
宁夏,2021,理科,5,621,101
宁夏,2021,理科,1,620,102
宁夏,2021,理科,3,619,105
宁夏,2021,理科,3,618,108
宁夏,2021,理科,4,617,112
宁夏,2021,理科,5,616,117
宁夏,2021,理科,7,615,124
宁夏,2021,理科,6,614,130
宁夏,2021,理科,7,613,137
宁夏,2021,理科,3,612,140
宁夏,2021,理科,2,611,142
宁夏,2021,理科,8,610,150
宁夏,2021,理科,7,609,157
宁夏,2021,理科,5,608,162
宁夏,2021,理科,7,607,169
宁夏,2021,理科,9,606,178
宁夏,2021,理科,12,605,190
宁夏,2021,理科,9,604,199
宁夏,2021,理科,8,603,207
宁夏,2021,理科,6,602,213
宁夏,2021,理科,7,601,220
宁夏,2021,理科,13,600,233
宁夏,2021,理科,14,599,247
宁夏,2021,理科,7,598,254
宁夏,2021,理科,8,597,262
宁夏,2021,理科,15,596,277
宁夏,2021,理科,7,595,284
宁夏,2021,理科,7,594,291
宁夏,2021,理科,17,593,308
宁夏,2021,理科,17,592,325
宁夏,2021,理科,21,591,346
宁夏,2021,理科,15,590,361
宁夏,2021,理科,21,589,382
宁夏,2021,理科,10,588,392
宁夏,2021,理科,11,587,403
宁夏,2021,理科,12,586,415
宁夏,2021,理科,11,585,426
宁夏,2021,理科,15,584,441
宁夏,2021,理科,7,583,448
宁夏,2021,理科,15,582,463
宁夏,2021,理科,7,581,470
宁夏,2021,理科,11,580,481
宁夏,2021,理科,19,579,500
宁夏,2021,理科,20,578,520
宁夏,2021,理科,14,577,534
宁夏,2021,理科,14,576,548
宁夏,2021,理科,19,575,567
宁夏,2021,理科,19,574,586
宁夏,2021,理科,14,573,600
宁夏,2021,理科,16,572,616
宁夏,2021,理科,16,571,632
宁夏,2021,理科,17,570,649
宁夏,2021,理科,22,569,671
宁夏,2021,理科,15,568,686
宁夏,2021,理科,17,567,703
宁夏,2021,理科,23,566,726
宁夏,2021,理科,24,565,750
宁夏,2021,理科,13,564,763
宁夏,2021,理科,22,563,785
宁夏,2021,理科,26,562,811
宁夏,2021,理科,19,561,830
宁夏,2021,理科,25,560,855
宁夏,2021,理科,26,559,881
宁夏,2021,理科,24,558,905
宁夏,2021,理科,23,557,928
宁夏,2021,理科,28,556,956
宁夏,2021,理科,27,555,983
宁夏,2021,理科,31,554,1014
宁夏,2021,理科,34,553,1048
宁夏,2021,理科,30,552,1078
宁夏,2021,理科,32,551,1110
宁夏,2021,理科,25,550,1135
宁夏,2021,理科,30,549,1165
宁夏,2021,理科,35,548,1200
宁夏,2021,理科,27,547,1227
宁夏,2021,理科,38,546,1265
宁夏,2021,理科,36,545,1301
宁夏,2021,理科,20,544,1321
宁夏,2021,理科,30,543,1351
宁夏,2021,理科,28,542,1379
宁夏,2021,理科,35,541,1414
宁夏,2021,理科,29,540,1443
宁夏,2021,理科,39,539,1482
宁夏,2021,理科,33,538,1515
宁夏,2021,理科,32,537,1547
宁夏,2021,理科,36,536,1583
宁夏,2021,理科,29,535,1612
宁夏,2021,理科,30,534,1642
宁夏,2021,理科,35,533,1677
宁夏,2021,理科,40,532,1717
宁夏,2021,理科,35,531,1752
宁夏,2021,理科,39,530,1791
宁夏,2021,理科,33,529,1824
宁夏,2021,理科,48,528,1872
宁夏,2021,理科,47,527,1919
宁夏,2021,理科,37,526,1956
宁夏,2021,理科,38,525,1994
宁夏,2021,理科,41,524,2035
宁夏,2021,理科,54,523,2089
宁夏,2021,理科,45,522,2134
宁夏,2021,理科,40,521,2174
宁夏,2021,理科,41,520,2215
宁夏,2021,理科,36,519,2251
宁夏,2021,理科,60,518,2311
宁夏,2021,理科,46,517,2357
宁夏,2021,理科,55,516,2412
宁夏,2021,理科,52,515,2464
宁夏,2021,理科,52,514,2516
宁夏,2021,理科,48,513,2564
宁夏,2021,理科,43,512,2607
宁夏,2021,理科,62,511,2669
宁夏,2021,理科,41,510,2710
宁夏,2021,理科,59,509,2769
宁夏,2021,理科,38,508,2807
宁夏,2021,理科,53,507,2860
宁夏,2021,理科,60,506,2920
宁夏,2021,理科,55,505,2975
宁夏,2021,理科,46,504,3021
宁夏,2021,理科,65,503,3086
宁夏,2021,理科,50,502,3136
宁夏,2021,理科,56,501,3192
宁夏,2021,理科,58,500,3250
宁夏,2021,理科,56,499,3306
宁夏,2021,理科,60,498,3366
宁夏,2021,理科,63,497,3429
宁夏,2021,理科,72,496,3501
宁夏,2021,理科,65,495,3566
宁夏,2021,理科,60,494,3626
宁夏,2021,理科,71,493,3697
宁夏,2021,理科,70,492,3767
宁夏,2021,理科,90,491,3857
宁夏,2021,理科,79,490,3936
宁夏,2021,理科,76,489,4012
宁夏,2021,理科,64,488,4076
宁夏,2021,理科,75,487,4151
宁夏,2021,理科,60,486,4211
宁夏,2021,理科,69,485,4280
宁夏,2021,理科,86,484,4366
宁夏,2021,理科,80,483,4446
宁夏,2021,理科,74,482,4520
宁夏,2021,理科,86,481,4606
宁夏,2021,理科,73,480,4679
宁夏,2021,理科,67,479,4746
宁夏,2021,理科,97,478,4843
宁夏,2021,理科,78,477,4921
宁夏,2021,理科,82,476,5003
宁夏,2021,理科,77,475,5080
宁夏,2021,理科,77,474,5157
宁夏,2021,理科,74,473,5231
宁夏,2021,理科,109,472,5340
宁夏,2021,理科,108,471,5448
宁夏,2021,理科,109,470,5557
宁夏,2021,理科,115,469,5672
宁夏,2021,理科,109,468,5781
宁夏,2021,理科,96,467,5877
宁夏,2021,理科,109,466,5986
宁夏,2021,理科,97,465,6083
宁夏,2021,理科,111,464,6194
宁夏,2021,理科,107,463,6301
宁夏,2021,理科,97,462,6398
宁夏,2021,理科,90,461,6488
宁夏,2021,理科,97,460,6585
宁夏,2021,理科,99,459,6684
宁夏,2021,理科,117,458,6801
宁夏,2021,理科,105,457,6906
宁夏,2021,理科,114,456,7020
宁夏,2021,理科,117,455,7137
宁夏,2021,理科,110,454,7247
宁夏,2021,理科,113,453,7360
宁夏,2021,理科,111,452,7471
宁夏,2021,理科,120,451,7591
宁夏,2021,理科,124,450,7715
宁夏,2021,理科,132,449,7847
宁夏,2021,理科,124,448,7971
宁夏,2021,理科,121,447,8092
宁夏,2021,理科,130,446,8222
宁夏,2021,理科,135,445,8357
宁夏,2021,理科,143,444,8500
宁夏,2021,理科,133,443,8633
宁夏,2021,理科,144,442,8777
宁夏,2021,理科,126,441,8903
宁夏,2021,理科,147,440,9050
宁夏,2021,理科,137,439,9187
宁夏,2021,理科,125,438,9312
宁夏,2021,理科,140,437,9452
宁夏,2021,理科,135,436,9587
宁夏,2021,理科,142,435,9729
宁夏,2021,理科,157,434,9886
宁夏,2021,理科,129,433,10015
宁夏,2021,理科,138,432,10153
宁夏,2021,理科,149,431,10302
宁夏,2021,理科,136,430,10438
宁夏,2021,理科,138,429,10576
宁夏,2021,理科,163,428,10739
宁夏,2021,理科,134,427,10873
宁夏,2021,理科,151,426,11024
宁夏,2021,理科,148,425,11172
宁夏,2021,理科,153,424,11325
宁夏,2021,理科,173,423,11498
宁夏,2021,理科,160,422,11658
宁夏,2021,理科,149,421,11807
宁夏,2021,理科,152,420,11959
宁夏,2021,理科,161,419,12120
宁夏,2021,理科,132,418,12252
宁夏,2021,理科,180,417,12432
宁夏,2021,理科,161,416,12593
宁夏,2021,理科,145,415,12738
宁夏,2021,理科,153,414,12891
宁夏,2021,理科,152,413,13043
宁夏,2021,理科,177,412,13220
宁夏,2021,理科,163,411,13383
宁夏,2021,理科,157,410,13540
宁夏,2021,理科,181,409,13721
宁夏,2021,理科,157,408,13878
宁夏,2021,理科,174,407,14052
宁夏,2021,理科,159,406,14211
宁夏,2021,理科,155,405,14366
宁夏,2021,理科,172,404,14538
宁夏,2021,理科,160,403,14698
宁夏,2021,理科,165,402,14863
宁夏,2021,理科,141,401,15004
宁夏,2021,理科,172,400,15176
宁夏,2021,理科,172,399,15348
宁夏,2021,理科,178,398,15526
宁夏,2021,理科,182,397,15708
宁夏,2021,理科,160,396,15868
宁夏,2021,理科,177,395,16045
宁夏,2021,理科,195,394,16240
宁夏,2021,理科,184,393,16424
宁夏,2021,理科,164,392,16588
宁夏,2021,理科,173,391,16761
宁夏,2021,理科,175,390,16936
宁夏,2021,理科,151,389,17087
宁夏,2021,理科,158,388,17245
宁夏,2021,理科,152,387,17397
宁夏,2021,理科,157,386,17554
宁夏,2021,理科,169,385,17723
宁夏,2021,理科,183,384,17906
宁夏,2021,理科,176,383,18082
宁夏,2021,理科,152,382,18234
宁夏,2021,理科,185,381,18419
宁夏,2021,理科,164,380,18583
宁夏,2021,理科,167,379,18750
宁夏,2021,理科,195,378,18945
宁夏,2021,理科,195,377,19140
宁夏,2021,理科,179,376,19319
宁夏,2021,理科,170,375,19489
宁夏,2021,理科,163,374,19652
宁夏,2021,理科,176,373,19828
宁夏,2021,理科,191,372,20019
宁夏,2021,理科,159,371,20178
宁夏,2021,理科,178,370,20356
宁夏,2021,理科,203,369,20559
宁夏,2021,理科,163,368,20722
宁夏,2021,理科,162,367,20884
宁夏,2021,理科,180,366,21064
宁夏,2021,理科,155,365,21219
宁夏,2021,理科,156,364,21375
宁夏,2021,理科,166,363,21541
宁夏,2021,理科,169,362,21710
宁夏,2021,理科,143,361,21853
宁夏,2021,理科,152,360,22005
宁夏,2021,理科,148,359,22153
宁夏,2021,理科,154,358,22307
宁夏,2021,理科,167,357,22474
宁夏,2021,理科,158,356,22632
宁夏,2021,理科,162,355,22794
宁夏,2021,理科,166,354,22960
宁夏,2021,理科,162,353,23122
宁夏,2021,理科,158,352,23280
宁夏,2021,理科,167,351,23447
宁夏,2021,理科,135,350,23582
宁夏,2021,文科,246,600,246
宁夏,2021,文科,9,599,255
宁夏,2021,文科,18,598,273
宁夏,2021,文科,10,597,283
宁夏,2021,文科,10,596,293
宁夏,2021,文科,10,595,303
宁夏,2021,文科,8,594,311
宁夏,2021,文科,11,593,322
宁夏,2021,文科,8,592,330
宁夏,2021,文科,15,591,345
宁夏,2021,文科,10,590,355
宁夏,2021,文科,12,589,367
宁夏,2021,文科,9,588,376
宁夏,2021,文科,13,587,389
宁夏,2021,文科,10,586,399
宁夏,2021,文科,17,585,416
宁夏,2021,文科,11,584,427
宁夏,2021,文科,15,583,442
宁夏,2021,文科,17,582,459
宁夏,2021,文科,15,581,474
宁夏,2021,文科,21,580,495
宁夏,2021,文科,17,579,512
宁夏,2021,文科,17,578,529
宁夏,2021,文科,14,577,543
宁夏,2021,文科,17,576,560
宁夏,2021,文科,15,575,575
宁夏,2021,文科,28,574,603
宁夏,2021,文科,17,573,620
宁夏,2021,文科,17,572,637
宁夏,2021,文科,16,571,653
宁夏,2021,文科,12,570,665
宁夏,2021,文科,22,569,687
宁夏,2021,文科,21,568,708
宁夏,2021,文科,19,567,727
宁夏,2021,文科,23,566,750
宁夏,2021,文科,23,565,773
宁夏,2021,文科,22,564,795
宁夏,2021,文科,23,563,818
宁夏,2021,文科,22,562,840
宁夏,2021,文科,21,561,861
宁夏,2021,文科,13,560,874
宁夏,2021,文科,30,559,904
宁夏,2021,文科,31,558,935
宁夏,2021,文科,36,557,971
宁夏,2021,文科,22,556,993
宁夏,2021,文科,23,555,1016
宁夏,2021,文科,25,554,1041
宁夏,2021,文科,41,553,1082
宁夏,2021,文科,38,552,1120
宁夏,2021,文科,30,551,1150
宁夏,2021,文科,34,550,1184
宁夏,2021,文科,34,549,1218
宁夏,2021,文科,25,548,1243
宁夏,2021,文科,40,547,1283
宁夏,2021,文科,39,546,1322
宁夏,2021,文科,35,545,1357
宁夏,2021,文科,35,544,1392
宁夏,2021,文科,39,543,1431
宁夏,2021,文科,39,542,1470
宁夏,2021,文科,47,541,1517
宁夏,2021,文科,43,540,1560
宁夏,2021,文科,31,539,1591
宁夏,2021,文科,29,538,1620
宁夏,2021,文科,43,537,1663
宁夏,2021,文科,44,536,1707
宁夏,2021,文科,49,535,1756
宁夏,2021,文科,40,534,1796
宁夏,2021,文科,51,533,1847
宁夏,2021,文科,49,532,1896
宁夏,2021,文科,47,531,1943
宁夏,2021,文科,53,530,1996
宁夏,2021,文科,46,529,2042
宁夏,2021,文科,42,528,2084
宁夏,2021,文科,49,527,2133
宁夏,2021,文科,56,526,2189
宁夏,2021,文科,50,525,2239
宁夏,2021,文科,68,524,2307
宁夏,2021,文科,52,523,2359
宁夏,2021,文科,59,522,2418
宁夏,2021,文科,67,521,2485
宁夏,2021,文科,47,520,2532
宁夏,2021,文科,56,519,2588
宁夏,2021,文科,49,518,2637
宁夏,2021,文科,62,517,2699
宁夏,2021,文科,62,516,2761
宁夏,2021,文科,61,515,2822
宁夏,2021,文科,56,514,2878
宁夏,2021,文科,70,513,2948
宁夏,2021,文科,60,512,3008
宁夏,2021,文科,61,511,3069
宁夏,2021,文科,60,510,3129
宁夏,2021,文科,61,509,3190
宁夏,2021,文科,73,508,3263
宁夏,2021,文科,75,507,3338
宁夏,2021,文科,66,506,3404
宁夏,2021,文科,68,505,3472
宁夏,2021,文科,75,504,3547
宁夏,2021,文科,69,503,3616
宁夏,2021,文科,70,502,3686
宁夏,2021,文科,59,501,3745
宁夏,2021,文科,77,500,3822
宁夏,2021,文科,69,499,3891
宁夏,2021,文科,73,498,3964
宁夏,2021,文科,86,497,4050
宁夏,2021,文科,90,496,4140
宁夏,2021,文科,72,495,4212
宁夏,2021,文科,83,494,4295
宁夏,2021,文科,87,493,4382
宁夏,2021,文科,86,492,4468
宁夏,2021,文科,86,491,4554
宁夏,2021,文科,78,490,4632
宁夏,2021,文科,98,489,4730
宁夏,2021,文科,74,488,4804
宁夏,2021,文科,94,487,4898
宁夏,2021,文科,82,486,4980
宁夏,2021,文科,88,485,5068
宁夏,2021,文科,78,484,5146
宁夏,2021,文科,91,483,5237
宁夏,2021,文科,81,482,5318
宁夏,2021,文科,85,481,5403
宁夏,2021,文科,84,480,5487
宁夏,2021,文科,89,479,5576
宁夏,2021,文科,97,478,5673
宁夏,2021,文科,94,477,5767
宁夏,2021,文科,87,476,5854
宁夏,2021,文科,83,475,5937
宁夏,2021,文科,80,474,6017
宁夏,2021,文科,97,473,6114
宁夏,2021,文科,75,472,6189
宁夏,2021,文科,118,471,6307
宁夏,2021,文科,94,470,6401
宁夏,2021,文科,102,469,6503
宁夏,2021,文科,92,468,6595
宁夏,2021,文科,86,467,6681
宁夏,2021,文科,86,466,6767
宁夏,2021,文科,84,465,6851
宁夏,2021,文科,80,464,6931
宁夏,2021,文科,79,463,7010
宁夏,2021,文科,93,462,7103
宁夏,2021,文科,81,461,7184
宁夏,2021,文科,72,460,7256
宁夏,2021,文科,99,459,7355
宁夏,2021,文科,97,458,7452
宁夏,2021,文科,98,457,7550
宁夏,2021,文科,83,456,7633
宁夏,2021,文科,76,455,7709
宁夏,2021,文科,95,454,7804
宁夏,2021,文科,88,453,7892
宁夏,2021,文科,88,452,7980
宁夏,2021,文科,85,451,8065
宁夏,2021,文科,89,450,8154
宁夏,2021,文科,91,449,8245
宁夏,2021,文科,81,448,8326
宁夏,2021,文科,104,447,8430
宁夏,2021,文科,97,446,8527
宁夏,2021,文科,95,445,8622
宁夏,2021,文科,89,444,8711
宁夏,2021,文科,95,443,8806
宁夏,2021,文科,104,442,8910
宁夏,2021,文科,95,441,9005
宁夏,2021,文科,82,440,9087
宁夏,2021,文科,101,439,9188
宁夏,2021,文科,86,438,9274
宁夏,2021,文科,86,437,9360
宁夏,2021,文科,92,436,9452
宁夏,2021,文科,84,435,9536
宁夏,2021,文科,74,434,9610
宁夏,2021,文科,113,433,9723
宁夏,2021,文科,75,432,9798
宁夏,2021,文科,86,431,9884
宁夏,2021,文科,90,430,9974
宁夏,2021,文科,98,429,10072
宁夏,2021,文科,94,428,10166
宁夏,2021,文科,96,427,10262
宁夏,2021,文科,86,426,10348
宁夏,2021,文科,89,425,10437
宁夏,2021,文科,99,424,10536
宁夏,2021,文科,102,423,10638
宁夏,2021,文科,91,422,10729
宁夏,2021,文科,98,421,10827
宁夏,2021,文科,84,420,10911
宁夏,2021,文科,87,419,10998
宁夏,2021,文科,84,418,11082
宁夏,2021,文科,104,417,11186
宁夏,2021,文科,82,416,11268
宁夏,2021,文科,99,415,11367
宁夏,2021,文科,95,414,11462
宁夏,2021,文科,97,413,11559
宁夏,2021,文科,86,412,11645
宁夏,2021,文科,100,411,11745
宁夏,2021,文科,97,410,11842
宁夏,2021,文科,84,409,11926
宁夏,2021,文科,107,408,12033
宁夏,2021,文科,86,407,12119
宁夏,2021,文科,98,406,12217
宁夏,2021,文科,89,405,12306
宁夏,2021,文科,83,404,12389
宁夏,2021,文科,94,403,12483
宁夏,2021,文科,86,402,12569
宁夏,2021,文科,82,401,12651
宁夏,2021,文科,91,400,12742
